,tripid,shipperid,categoryid,customer,shipdate,origincity,originstate,shipdays,destinationcity,destinationstate,deliverydate,totalmiles,loadedmiles,shippingcost,revenue,capacity,triptype,checkpoints,newshipdate,newdeliverydate,month,day,profit,datediff,revenue running totel,cost running totel
970,10971,2,3,Condintex,01-01-2016,Springfield,IL,2,Skokie,IL,03-01-2016,710,710,1122,1831,78,Domestic,1,2016-01-01,2016-01-03,1,1,709,2 days,1831,1122
952,10953,3,3,Plusla,01-01-2016,Chicago,IL,5,Rockford,IL,05-01-2016,780,275,5832,6808,82,International,4,2016-01-01,2016-01-05,1,1,976,4 days,8639,6954
520,10521,2,6,hat-core,01-01-2016,Madison,WI,1,Kalamazoo,MI,02-01-2016,983,231,1239,1720,73,Domestic,3,2016-01-01,2016-01-02,1,1,481,1 days,10359,8193
345,10346,2,6,Zoodrill,01-01-2016,Naperville,IL,1,Indianapolis,IN,02-01-2016,224,224,8501,8941,65,Domestic,10,2016-01-01,2016-01-02,1,1,440,1 days,19300,16694
1170,11171,2,4,Gogokeying,01-01-2016,Indianapolis,IN,2,Northbrook,IL,02-01-2016,1119,788,2508,201,72,Domestic,8,2016-01-01,2016-01-02,1,1,-2307,1 days,19501,19202
1703,11704,2,3,Unatrax,01-01-2016,Cincinnati,OH,1,Gary,IN,02-01-2016,365,365,4465,4971,72,Domestic,7,2016-01-01,2016-01-02,1,1,506,1 days,24472,23667
635,10636,1,7,xx-bam,01-01-2016,Cincinnati,OH,7,Gary,IN,08-01-2016,402,402,677,911,98,International,8,2016-01-01,2016-01-08,1,1,234,7 days,25383,24344
1120,11121,2,1,Icedox,01-01-2016,Grand Rapids,MI,3,Toledo,OH,02-01-2016,357,238,2276,7388,60,Domestic,10,2016-01-01,2016-01-02,1,1,5112,1 days,32771,26620
844,10845,2,3,Joyzim,01-01-2016,Detriot,MI,1,Monon,IN,02-01-2016,392,273,2981,3487,95,Domestic,8,2016-01-01,2016-01-02,1,1,506,1 days,36258,29601
482,10483,2,7,Gravemedia,02-01-2016,Cincinnati,OH,3,Gary,IN,05-01-2016,724,314,2176,2933,59,Domestic,6,2016-01-02,2016-01-05,1,2,757,3 days,39191,31777
271,10272,1,8,Finlux,02-01-2016,Milwaukee,WI,10,Springfield,IL,21-03-2016,951,639,6711,7603,60,International,10,2016-01-02,2016-03-21,1,2,892,79 days,46794,38488
1256,11257,3,6,Scotfase,02-01-2016,Chicago,IL,2,Rockford,IL,04-01-2016,402,268,1419,1748,56,Domestic,9,2016-01-02,2016-01-04,1,2,329,2 days,48542,39907
89,10090,1,4,bluecorporation,02-01-2016,Green Bay,WI,1,Joliet,IL,03-01-2016,919,445,5920,4258,53,Domestic,1,2016-01-02,2016-01-03,1,2,-1662,1 days,52800,45827
1572,11573,2,3,Pluslam,02-01-2016,Northbrook,IL,9,Naperville,IL,21-03-2016,1167,294,8090,8858,76,International,4,2016-01-02,2016-03-21,1,2,768,79 days,61658,53917
1321,11322,2,6,Zunice,02-01-2016,Grand Rapids,MI,1,Toledo,OH,03-01-2016,652,652,318,756,61,Domestic,4,2016-01-02,2016-01-03,1,2,438,1 days,62414,54235
782,10783,1,6,Alphafan,03-01-2016,Madison,WI,2,Kalamazoo,MI,05-01-2016,800,228,4402,4955,61,Intercom,4,2016-01-03,2016-01-05,1,3,553,2 days,67369,58637
18,10019,2,7,hottaxon,03-01-2016,Skokie,IL,2,Chicago,IL,05-01-2016,786,347,3801,4080,54,Domestic,7,2016-01-03,2016-01-05,1,3,279,2 days,71449,62438
831,10832,1,6,Jobtechnology,03-01-2016,Toledo,OH,9,Detriot,MI,12-01-2016,933,390,7526,8015,86,International,5,2016-01-03,2016-01-12,1,3,489,9 days,79464,69964
134,10135,1,5,Cityis,03-01-2016,Rockford,IL,4,Green Bay,WI,07-01-2016,492,492,2190,3072,81,Domestic,10,2016-01-03,2016-01-07,1,3,882,4 days,82536,72154
1509,11510,3,1,Lazap,03-01-2016,Naperville,IL,2,Indianapolis,IN,04-01-2016,719,263,4280,8990,94,Domestic,2,2016-01-03,2016-01-04,1,3,4710,1 days,91526,76434
1201,11202,3,4,hottaxon,03-01-2016,Rockford,IL,6,Green Bay,WI,21-03-2016,224,224,2772,1113,72,International,3,2016-01-03,2016-03-21,1,3,-1659,78 days,92639,79206
701,10702,1,4,Zimjiit,03-01-2016,Cincinnati,OH,1,Gary,IN,04-01-2016,353,305,4545,3118,59,Domestic,7,2016-01-03,2016-01-04,1,3,-1427,1 days,95757,83751
1483,11484,2,4,Reddoit,03-01-2016,Joliet,IL,4,Madison,WI,05-01-2016,803,707,7036,4861,52,Domestic,2,2016-01-03,2016-01-05,1,3,-2175,2 days,100618,90787
1614,11615,2,3,Tantax,03-01-2016,Monon,IN,2,Lansing,MI,05-01-2016,719,655,1584,2007,76,Domestic,9,2016-01-03,2016-01-05,1,3,423,2 days,102625,92371
457,10458,1,8,Fixace,03-01-2016,Naperville,IL,2,Indianapolis,IN,05-01-2016,1180,439,1930,2770,64,Domestic,1,2016-01-03,2016-01-05,1,3,840,2 days,105395,94301
38,10039,1,7,Tamcan,03-01-2016,Skokie,IL,3,Chicago,IL,06-01-2016,948,684,1212,1568,66,Domestic,8,2016-01-03,2016-01-06,1,3,356,3 days,106963,95513
653,10654,2,6,Vaiazozice,03-01-2016,Madison,WI,6,Kalamazoo,MI,09-01-2016,552,266,6595,7202,57,International,10,2016-01-03,2016-01-09,1,3,607,6 days,114165,102108
445,10446,2,8,Faseron,04-01-2016,Kalamazoo,MI,4,Bangor,MI,08-01-2016,1003,302,7392,8099,58,Domestic,6,2016-01-04,2016-01-08,1,4,707,4 days,122264,109500
310,10311,2,6,Baselux,04-01-2016,Skokie,IL,2,Chicago,IL,06-01-2016,442,442,3630,3900,90,Domestic,6,2016-01-04,2016-01-06,1,4,270,2 days,126164,113130
855,10856,1,6,Tempfan,04-01-2016,Toledo,OH,10,Detriot,MI,21-03-2016,342,253,6202,6946,83,International,3,2016-01-04,2016-03-21,1,4,744,77 days,133110,119332
1055,11056,2,1,Daltcare,04-01-2016,Grand Rapids,MI,2,Toledo,OH,06-01-2016,1026,650,7924,12343,74,Domestic,2,2016-01-04,2016-01-06,1,4,4419,2 days,145453,127256
1735,11736,3,6,Howelectrics,04-01-2016,Springfield,IL,1,Skokie,IL,05-01-2016,909,551,595,1218,96,Domestic,8,2016-01-04,2016-01-05,1,4,623,1 days,146671,127851
420,10421,1,6,Zapline,04-01-2016,Bangor,MI,1,Davenport,IA,05-01-2016,1099,690,8256,8689,58,Domestic,1,2016-01-04,2016-01-05,1,4,433,1 days,155360,136107
225,10226,2,5,Donelectrics,04-01-2016,Davenport,IA,4,Appleton,WI,08-01-2016,742,215,4958,5087,58,Domestic,6,2016-01-04,2016-01-08,1,4,129,4 days,160447,141065
884,10885,2,5,Reddoit,04-01-2016,Grand Rapids,MI,4,Toledo,OH,08-01-2016,736,353,1214,2153,97,Domestic,4,2016-01-04,2016-01-08,1,4,939,4 days,162600,142279
1472,11473,3,3,Gogokeying,04-01-2016,Elgin,IL,1,Cincinnati,OH,04-01-2016,936,693,862,1406,98,Domestic,6,2016-01-04,2016-01-04,1,4,544,0 days,164006,143141
765,10766,1,4,Canecare,04-01-2016,Dayton,OH,3,Elgin,IL,07-01-2016,1163,551,6799,4125,93,Domestic,4,2016-01-04,2016-01-07,1,4,-2674,3 days,168131,149940
391,10392,2,7,Strongtechnology,05-01-2016,Rockford,IL,1,Green Bay,WI,06-01-2016,868,335,5294,5574,79,Domestic,10,2016-01-05,2016-01-06,1,5,280,1 days,173705,155234
672,10673,1,5,Singleholdings,05-01-2016,Gary,IN,5,Milwaukee,WI,10-01-2016,1071,546,8603,8817,91,International,6,2016-01-05,2016-01-10,1,5,214,5 days,182522,163837
23,10024,1,4,Stimmedia,05-01-2016,Chicago,IL,2,Rockford,IL,07-01-2016,1004,289,4025,2598,52,Domestic,6,2016-01-05,2016-01-07,1,5,-1427,2 days,185120,167862
1405,11406,3,3,hotity,06-01-2016,Lansing,MI,1,Dayton,OH,07-01-2016,1121,646,7386,7563,67,Intercom,1,2016-01-06,2016-01-07,1,6,177,1 days,192683,175248
1114,11115,3,6,Zunzone,06-01-2016,Toledo,OH,4,Detriot,MI,10-01-2016,509,218,359,1117,82,Domestic,2,2016-01-06,2016-01-10,1,6,758,4 days,193800,175607
699,10700,1,4,Dripvivadex,06-01-2016,Rockford,IL,3,Green Bay,WI,09-01-2016,419,419,6312,4268,93,Domestic,6,2016-01-06,2016-01-09,1,6,-2044,3 days,198068,181919
1041,11042,2,6,Geoit,06-01-2016,Joliet,IL,2,Madison,WI,07-01-2016,721,262,7301,7775,67,Domestic,6,2016-01-06,2016-01-07,1,6,474,1 days,205843,189220
320,10321,2,4,Canemedkix,06-01-2016,Monon,IN,7,Lansing,MI,13-01-2016,352,352,4871,3056,62,International,10,2016-01-06,2016-01-13,1,6,-1815,7 days,208899,194091
965,10966,2,5,Vaiataxon,07-01-2016,Elgin,IL,1,Cincinnati,OH,08-01-2016,546,546,6102,7028,67,Domestic,7,2016-01-07,2016-01-08,1,7,926,1 days,215927,200193
535,10536,2,6,Daltron,08-01-2016,Springfield,IL,4,Skokie,IL,12-01-2016,1153,360,1274,2190,64,Domestic,10,2016-01-08,2016-01-12,1,8,916,4 days,218117,201467
1311,11312,2,6,Lexiplus,08-01-2016,Rockford,IL,10,Green Bay,WI,21-03-2016,323,208,3222,3480,94,International,1,2016-01-08,2016-03-21,1,8,258,73 days,221597,204689
1216,11217,2,3,Cannamcon,08-01-2016,Indianapolis,IN,4,Northbrook,IL,09-01-2016,838,422,229,1033,52,Domestic,1,2016-01-08,2016-01-09,1,8,804,1 days,222630,204918
1028,11029,2,3,stripzim,08-01-2016,Dayton,OH,2,Elgin,IL,10-01-2016,822,669,6135,6669,71,Domestic,1,2016-01-08,2016-01-10,1,8,534,2 days,229299,211053
1431,11432,3,1,dan-high,08-01-2016,Grand Rapids,MI,4,Toledo,OH,12-01-2016,505,346,518,5502,95,Domestic,10,2016-01-08,2016-01-12,1,8,4984,4 days,234801,211571
1439,11440,2,6,Dongbase,08-01-2016,Monon,IN,7,Lansing,MI,21-03-2016,590,498,4901,5051,62,International,3,2016-01-08,2016-03-21,1,8,150,73 days,239852,216472
1799,11800,2,6,Ganjazone,08-01-2016,Elgin,IL,3,Cincinnati,OH,09-01-2016,1135,518,431,872,66,Domestic,8,2016-01-08,2016-01-09,1,8,441,1 days,240724,216903
1760,11761,2,1,Redozetam,08-01-2016,Chicago,IL,1,Rockford,IL,09-01-2016,735,458,4412,8998,85,Domestic,4,2016-01-08,2016-01-09,1,8,4586,1 days,249722,221315
1501,11502,3,4,Ganjazone,08-01-2016,Indianapolis,IN,2,Northbrook,IL,08-01-2016,595,585,6342,4315,83,Domestic,4,2016-01-08,2016-01-08,1,8,-2027,0 days,254037,227657
1416,11417,3,3,O-ace,08-01-2016,Gary,IN,1,Milwaukee,WI,09-01-2016,886,203,25,847,54,Domestic,5,2016-01-08,2016-01-09,1,8,822,1 days,254884,227682
1778,11779,2,5,Funfintech,09-01-2016,Kalamazoo,MI,1,Bangor,MI,10-01-2016,941,290,2450,2877,78,Domestic,8,2016-01-09,2016-01-10,1,9,427,1 days,257761,230132
1290,11291,2,5,Whitekix,09-01-2016,Dayton,OH,9,Elgin,IL,18-01-2016,866,200,769,1756,61,International,5,2016-01-09,2016-01-18,1,9,987,9 days,259517,230901
814,10815,2,7,Linezatlam,09-01-2016,Kalamazoo,MI,6,Bangor,MI,15-01-2016,1153,673,6089,6622,51,International,2,2016-01-09,2016-01-15,1,9,533,6 days,266139,236990
611,10612,2,6,Dingity,09-01-2016,Appleton,WI,3,Grand Rapids,MI,12-01-2016,1057,534,51,1038,65,Domestic,6,2016-01-09,2016-01-12,1,9,987,3 days,267177,237041
984,10985,3,6,roundphase,09-01-2016,Dayton,OH,4,Elgin,IL,13-01-2016,866,474,8231,8658,75,Domestic,1,2016-01-09,2016-01-13,1,9,427,4 days,275835,245272
9,10010,1,7,Dentocity,10-01-2016,Madison,WI,5,Kalamazoo,MI,15-01-2016,732,248,3718,3916,63,International,10,2016-01-10,2016-01-15,1,10,198,5 days,279751,248990
896,10897,2,3,Subdrill,10-01-2016,Rockford,IL,4,Green Bay,WI,14-01-2016,954,515,5908,6900,54,Domestic,4,2016-01-10,2016-01-14,1,10,992,4 days,286651,254898
120,10121,1,6,Lexiplus,10-01-2016,Skokie,IL,4,Chicago,IL,14-01-2016,1085,716,7184,7901,73,Domestic,10,2016-01-10,2016-01-14,1,10,717,4 days,294552,262082
467,10468,2,5,Goldenlex,10-01-2016,Davenport,IA,1,Appleton,WI,11-01-2016,675,675,2677,3669,77,Domestic,8,2016-01-10,2016-01-11,1,10,992,1 days,298221,264759
496,10497,1,6,Runhigh,10-01-2016,Joliet,IL,2,Madison,WI,11-01-2016,980,303,2430,2818,94,Domestic,3,2016-01-10,2016-01-11,1,10,388,1 days,301039,267189
1001,11002,3,4,Solostreet,10-01-2016,Naperville,IL,2,Indianapolis,IN,12-01-2016,463,202,2362,478,76,Domestic,10,2016-01-10,2016-01-12,1,10,-1884,2 days,301517,269551
704,10705,2,4,Canetechnology,10-01-2016,Lansing,MI,2,Dayton,OH,12-01-2016,1196,410,8138,6536,89,Domestic,8,2016-01-10,2016-01-12,1,10,-1602,2 days,308053,277689
410,10411,2,7,Silverace,10-01-2016,Monon,IN,3,Lansing,MI,13-01-2016,326,326,3808,4093,80,Domestic,6,2016-01-10,2016-01-13,1,10,285,3 days,312146,281497
119,10120,1,6,Ronplanet,10-01-2016,Elgin,IL,2,Cincinnati,OH,11-01-2016,294,294,5431,5627,80,Domestic,4,2016-01-10,2016-01-11,1,10,196,1 days,317773,286928
294,10295,2,6,Indi-dox,10-01-2016,Chicago,IL,8,Rockford,IL,16-01-2016,482,217,3007,3735,85,International,9,2016-01-10,2016-01-16,1,10,728,6 days,321508,289935
764,10765,2,6,Goldenlex,11-01-2016,Cincinnati,OH,2,Gary,IN,13-01-2016,1068,270,6669,7194,85,Domestic,3,2016-01-11,2016-01-13,1,11,525,2 days,328702,296604
411,10412,1,5,Conelane,11-01-2016,Madison,WI,4,Kalamazoo,MI,15-01-2016,225,225,128,868,81,Domestic,7,2016-01-11,2016-01-15,1,11,740,4 days,329570,296732
544,10545,1,8,Silver-line,11-01-2016,Cincinnati,OH,3,Gary,IN,14-01-2016,1054,353,6526,6895,61,Domestic,1,2016-01-11,2016-01-14,1,11,369,3 days,336465,303258
708,10709,1,7,apzone,12-01-2016,Kalamazoo,MI,7,Bangor,MI,19-01-2016,319,319,1570,2508,61,International,10,2016-01-12,2016-01-19,1,12,938,7 days,338973,304828
624,10625,1,4,Xx-dotone,12-01-2016,Indianapolis,IN,4,Northbrook,IL,15-01-2016,347,347,6215,4341,78,Domestic,2,2016-01-12,2016-01-15,1,12,-1874,3 days,343314,311043
70,10071,2,8,Zimity,12-01-2016,Appleton,WI,4,Grand Rapids,MI,16-01-2016,701,668,2102,2846,67,Domestic,1,2016-01-12,2016-01-16,1,12,744,4 days,346160,313145
358,10359,1,6,Newzap,12-01-2016,Indianapolis,IN,5,Northbrook,IL,17-01-2016,346,346,1347,2119,79,International,6,2016-01-12,2016-01-17,1,12,772,5 days,348279,314492
157,10158,2,5,Lexidom,12-01-2016,Appleton,WI,1,Grand Rapids,MI,13-01-2016,653,207,6603,7192,75,Domestic,8,2016-01-12,2016-01-13,1,12,589,1 days,355471,321095
761,10762,1,8,Dongtinlux,12-01-2016,Naperville,IL,7,Indianapolis,IN,19-01-2016,842,455,5741,6617,61,International,4,2016-01-12,2016-01-19,1,12,876,7 days,362088,326836
573,10574,2,5,tinron,13-01-2016,Skokie,IL,2,Chicago,IL,15-01-2016,670,487,6338,7289,58,Domestic,6,2016-01-13,2016-01-15,1,13,951,2 days,369377,333174
853,10854,1,2,Canex,13-01-2016,Cincinnati,OH,10,Gary,IN,23-01-2016,581,581,1295,2006,51,International,9,2016-01-13,2016-01-23,1,13,711,10 days,371383,334469
1517,11518,2,6,Cannamcon,13-01-2016,Elgin,IL,3,Cincinnati,OH,16-01-2016,1055,582,1074,1576,95,Domestic,10,2016-01-13,2016-01-16,1,13,502,3 days,372959,335543
342,10343,2,5,Goldenbam,13-01-2016,Monon,IN,8,Lansing,MI,21-03-2016,944,702,1383,1968,77,International,4,2016-01-13,2016-03-21,1,13,585,68 days,374927,336926
1762,11763,3,3,zen-holdings,13-01-2016,Northbrook,IL,7,Naperville,IL,20-01-2016,490,251,8850,8977,60,International,9,2016-01-13,2016-01-20,1,13,127,7 days,383904,345776
829,10830,2,6,Siliconcore,13-01-2016,Cincinnati,OH,4,Gary,IN,17-01-2016,794,453,4939,5773,51,Domestic,8,2016-01-13,2016-01-17,1,13,834,4 days,389677,350715
1598,11599,3,1,Trustcorporation,13-01-2016,Appleton,WI,3,Grand Rapids,MI,16-01-2016,202,202,2830,6860,96,Domestic,2,2016-01-13,2016-01-16,1,13,4030,3 days,396537,353545
1334,11335,3,6,Quadplanet,13-01-2016,Cincinnati,OH,9,Gary,IN,21-01-2016,333,333,8196,8694,96,International,2,2016-01-13,2016-01-21,1,13,498,8 days,405231,361741
99,10100,1,5,Strongtechnology,14-01-2016,Skokie,IL,4,Chicago,IL,18-01-2016,362,362,3690,4608,99,Domestic,2,2016-01-14,2016-01-18,1,14,918,4 days,409839,365431
1083,11084,3,2,Zoomhex,14-01-2016,Gary,IN,3,Milwaukee,WI,17-01-2016,860,734,1905,2599,93,Domestic,8,2016-01-14,2016-01-17,1,14,694,3 days,412438,367336
122,10123,2,8,Quotefix,14-01-2016,Davenport,IA,2,Appleton,WI,16-01-2016,1192,730,1928,2138,97,Domestic,10,2016-01-14,2016-01-16,1,14,210,2 days,414576,369264
393,10394,1,4,Donplanet,14-01-2016,Cincinnati,OH,2,Gary,IN,16-01-2016,895,739,1890,623,88,Domestic,8,2016-01-14,2016-01-16,1,14,-1267,2 days,415199,371154
370,10371,1,8,Gravetech,15-01-2016,Dayton,OH,2,Elgin,IL,17-01-2016,676,223,295,515,78,Domestic,6,2016-01-15,2016-01-17,1,15,220,2 days,415714,371449
660,10661,2,5,Dontam,15-01-2016,Lansing,MI,6,Dayton,OH,20-01-2016,513,435,8053,8593,66,International,9,2016-01-15,2016-01-20,1,15,540,5 days,424307,379502
1803,11804,3,2,zotit,15-01-2016,Milwaukee,WI,6,Springfield,IL,21-03-2016,364,364,5284,5784,88,International,5,2016-01-15,2016-03-21,1,15,500,66 days,430091,384786
1521,11522,2,1,Zoncone,15-01-2016,Grand Rapids,MI,2,Toledo,OH,16-01-2016,330,330,7992,12494,68,Domestic,5,2016-01-15,2016-01-16,1,15,4502,1 days,442585,392778
1410,11411,3,3,acequote,15-01-2016,Grand Rapids,MI,2,Toledo,OH,16-01-2016,338,338,3162,3345,76,Domestic,10,2016-01-15,2016-01-16,1,15,183,1 days,445930,395940
1763,11764,3,2,Warebam,15-01-2016,Detriot,MI,9,Monon,IN,24-01-2016,376,376,7800,8382,66,International,8,2016-01-15,2016-01-24,1,15,582,9 days,454312,403740
1507,11508,3,2,scotquote,16-01-2016,Madison,WI,3,Kalamazoo,MI,19-01-2016,1006,459,3428,4295,84,Domestic,7,2016-01-16,2016-01-19,1,16,867,3 days,458607,407168
1014,11015,3,1,Solohex,16-01-2016,Springfield,IL,9,Skokie,IL,25-01-2016,778,614,3562,7865,72,International,5,2016-01-16,2016-01-25,1,16,4303,9 days,466472,410730
882,10883,2,6,Funfintech,16-01-2016,Kalamazoo,MI,1,Bangor,MI,17-01-2016,755,397,5933,6638,54,Domestic,9,2016-01-16,2016-01-17,1,16,705,1 days,473110,416663
505,10506,1,4,hotity,16-01-2016,Lansing,MI,9,Dayton,OH,25-01-2016,1032,409,5465,3481,90,International,9,2016-01-16,2016-01-25,1,16,-1984,9 days,476591,422128
1615,11616,2,6,Solohex,16-01-2016,Madison,WI,2,Kalamazoo,MI,18-01-2016,319,319,1234,2045,65,Domestic,7,2016-01-16,2016-01-18,1,16,811,2 days,478636,423362
170,10171,2,5,Mediaware,16-01-2016,Detriot,MI,9,Monon,IN,24-01-2016,530,530,4071,4550,87,International,7,2016-01-16,2016-01-24,1,16,479,8 days,483186,427433
261,10262,2,5,Itcantrans,16-01-2016,Cincinnati,OH,2,Gary,IN,18-01-2016,890,569,4835,5208,68,Domestic,7,2016-01-16,2016-01-18,1,16,373,2 days,488394,432268
475,10476,2,7,Indigoice,17-01-2016,Gary,IN,3,Milwaukee,WI,20-01-2016,567,404,113,418,90,Domestic,3,2016-01-17,2016-01-20,1,17,305,3 days,488812,432381
1704,11705,3,2,acequote,17-01-2016,Dayton,OH,4,Elgin,IL,18-01-2016,972,551,5565,5996,86,Domestic,5,2016-01-17,2016-01-18,1,17,431,1 days,494808,437946
1629,11630,2,5,Dingquokix,17-01-2016,Milwaukee,WI,4,Springfield,IL,21-01-2016,568,420,401,1235,63,Domestic,3,2016-01-17,2016-01-21,1,17,834,4 days,496043,438347
1520,11521,3,6,applanet,17-01-2016,Davenport,IA,6,Appleton,WI,22-01-2016,482,366,4671,5445,55,International,7,2016-01-17,2016-01-22,1,17,774,5 days,501488,443018
642,10643,2,7,Tamholding,17-01-2016,Davenport,IA,8,Appleton,WI,24-01-2016,970,497,7742,8687,63,International,5,2016-01-17,2016-01-24,1,17,945,7 days,510175,450760
339,10340,1,7,Mathing,18-01-2016,Detriot,MI,9,Monon,IN,27-01-2016,754,754,6150,6476,68,International,8,2016-01-18,2016-01-27,1,18,326,9 days,516651,456910
1562,11563,2,5,Scotfase,18-01-2016,Bangor,MI,3,Davenport,IA,21-01-2016,398,398,7382,8187,86,Domestic,8,2016-01-18,2016-01-21,1,18,805,3 days,524838,464292
316,10317,1,5,Solholdings,18-01-2016,Chicago,IL,2,Rockford,IL,20-01-2016,874,548,1677,1943,83,Domestic,1,2016-01-18,2016-01-20,1,18,266,2 days,526781,465969
174,10175,2,5,Ganzsannix,18-01-2016,Green Bay,WI,4,Joliet,IL,22-01-2016,813,241,4154,4927,80,Domestic,5,2016-01-18,2016-01-22,1,18,773,4 days,531708,470123
1423,11424,2,3,Icedox,19-01-2016,Dayton,OH,1,Elgin,IL,20-01-2016,346,346,3263,3512,98,Domestic,6,2016-01-19,2016-01-20,1,19,249,1 days,535220,473386
1103,11104,2,1,Technodax,19-01-2016,Northbrook,IL,10,Naperville,IL,29-01-2016,1130,788,3677,7917,99,International,6,2016-01-19,2016-01-29,1,19,4240,10 days,543137,477063
257,10258,1,6,citydexon,19-01-2016,Green Bay,WI,6,Joliet,IL,22-01-2016,1145,583,7890,8331,68,International,2,2016-01-19,2016-01-22,1,19,441,3 days,551468,484953
1090,11091,3,2,Inchholdings,19-01-2016,Cincinnati,OH,4,Gary,IN,23-01-2016,1155,455,6654,7506,77,Domestic,4,2016-01-19,2016-01-23,1,19,852,4 days,558974,491607
705,10706,2,6,Zotcare,19-01-2016,Bangor,MI,2,Davenport,IA,21-01-2016,1035,220,392,742,86,Domestic,10,2016-01-19,2016-01-21,1,19,350,2 days,559716,491999
837,10838,1,4,Triootity,19-01-2016,Davenport,IA,1,Appleton,WI,20-01-2016,1130,636,5040,3126,51,Domestic,6,2016-01-19,2016-01-20,1,19,-1914,1 days,562842,497039
1721,11722,3,6,Donremlane,19-01-2016,Green Bay,WI,3,Joliet,IL,22-01-2016,560,560,7332,8272,81,Domestic,10,2016-01-19,2016-01-22,1,19,940,3 days,571114,504371
1075,11076,2,1,Gravemedia,19-01-2016,Davenport,IA,9,Appleton,WI,26-01-2016,448,448,5012,9455,98,International,5,2016-01-19,2016-01-26,1,19,4443,7 days,580569,509383
647,10648,1,6,Zoodrill,20-01-2016,Indianapolis,IN,4,Northbrook,IL,24-01-2016,1143,591,6993,7568,67,Domestic,3,2016-01-20,2016-01-24,1,20,575,4 days,588137,516376
1155,11156,3,1,saltlab,20-01-2016,Rockford,IL,2,Green Bay,WI,22-01-2016,774,217,4269,8935,85,Domestic,2,2016-01-20,2016-01-22,1,20,4666,2 days,597072,520645
1132,11133,3,5,Danfan,20-01-2016,Naperville,IL,4,Indianapolis,IN,23-01-2016,360,212,1749,2438,63,Domestic,6,2016-01-20,2016-01-23,1,20,689,3 days,599510,522394
265,10266,1,7,Redozetam,20-01-2016,Bangor,MI,1,Davenport,IA,21-01-2016,585,251,5588,6279,56,Domestic,1,2016-01-20,2016-01-21,1,20,691,1 days,605789,527982
235,10236,2,6,Daltron,21-01-2016,Madison,WI,2,Kalamazoo,MI,23-01-2016,404,404,8216,8605,97,Intercom,7,2016-01-21,2016-01-23,1,21,389,2 days,614394,536198
306,10307,2,8,Villacom,21-01-2016,Dayton,OH,6,Elgin,IL,27-01-2016,742,698,4823,5181,86,International,3,2016-01-21,2016-01-27,1,21,358,6 days,619575,541021
45,10046,1,4,dripkix,21-01-2016,Northbrook,IL,5,Naperville,IL,21-03-2016,1008,778,5397,3284,71,International,4,2016-01-21,2016-03-21,1,21,-2113,60 days,622859,546418
507,10508,2,4,Striplane,21-01-2016,Elgin,IL,9,Cincinnati,OH,30-01-2016,1165,437,3166,1238,71,International,10,2016-01-21,2016-01-30,1,21,-1928,9 days,624097,549584
1672,11673,2,5,Fixcan,21-01-2016,Springfield,IL,9,Skokie,IL,30-01-2016,721,457,7770,8533,95,International,7,2016-01-21,2016-01-30,1,21,763,9 days,632630,557354
1168,11169,3,1,Zamlane,22-01-2016,Springfield,IL,8,Skokie,IL,28-01-2016,737,211,262,5340,56,International,5,2016-01-22,2016-01-28,1,22,5078,6 days,637970,557616
292,10293,1,8,san-plex,22-01-2016,Milwaukee,WI,4,Springfield,IL,26-01-2016,805,594,6423,7059,79,Domestic,5,2016-01-22,2016-01-26,1,22,636,4 days,645029,564039
1428,11429,3,5,Streetlam,22-01-2016,Skokie,IL,4,Chicago,IL,26-01-2016,316,316,3973,4959,68,Domestic,7,2016-01-22,2016-01-26,1,22,986,4 days,649988,568012
1052,11053,3,5,tres-tone,22-01-2016,Skokie,IL,10,Chicago,IL,21-03-2016,975,414,6217,6748,94,International,1,2016-01-22,2016-03-21,1,22,531,59 days,656736,574229
935,10936,2,4,xx-bam,22-01-2016,Gary,IN,10,Milwaukee,WI,29-01-2016,1037,352,2456,604,55,International,9,2016-01-22,2016-01-29,1,22,-1852,7 days,657340,576685
476,10477,2,8,Zotfan,23-01-2016,Joliet,IL,2,Madison,WI,25-01-2016,571,361,5270,5537,87,Domestic,6,2016-01-23,2016-01-25,1,23,267,2 days,662877,581955
435,10436,1,5,Y-flex,23-01-2016,Green Bay,WI,9,Joliet,IL,01-02-2016,266,266,6255,6656,88,International,5,2016-01-23,2016-02-01,1,23,401,9 days,669533,588210
234,10235,1,7,Jobtechnology,23-01-2016,Monon,IN,10,Lansing,MI,21-03-2016,302,302,679,814,70,International,1,2016-01-23,2016-03-21,1,23,135,58 days,670347,588889
429,10430,1,5,Cityis,23-01-2016,Northbrook,IL,1,Naperville,IL,24-01-2016,528,409,5942,6779,83,Domestic,4,2016-01-23,2016-01-24,1,23,837,1 days,677126,594831
49,10050,2,5,Zuntexon,23-01-2016,Madison,WI,10,Kalamazoo,MI,01-02-2016,254,254,3221,3441,71,International,10,2016-01-23,2016-02-01,1,23,220,9 days,680567,598052
1088,11089,2,1,Golddexon,23-01-2016,Rockford,IL,7,Green Bay,WI,21-03-2016,375,375,2617,8076,60,International,2,2016-01-23,2016-03-21,1,23,5459,58 days,688643,600669
94,10095,1,4,roundphase,23-01-2016,Dayton,OH,9,Elgin,IL,01-02-2016,1170,444,4594,3406,61,International,10,2016-01-23,2016-02-01,1,23,-1188,9 days,692049,605263
706,10707,2,6,Solostreet,24-01-2016,Elgin,IL,4,Cincinnati,OH,25-01-2016,202,202,380,792,96,Domestic,8,2016-01-24,2016-01-25,1,24,412,1 days,692841,605643
1189,11190,3,2,Howtaxon,24-01-2016,Davenport,IA,8,Appleton,WI,31-01-2016,814,695,7739,8360,64,International,4,2016-01-24,2016-01-31,1,24,621,7 days,701201,613382
173,10174,1,5,Zumcane,24-01-2016,Monon,IN,4,Lansing,MI,28-01-2016,392,392,7024,7175,78,Domestic,3,2016-01-24,2016-01-28,1,24,151,4 days,708376,620406
351,10352,1,4,nimlab,24-01-2016,Elgin,IL,3,Cincinnati,OH,27-01-2016,571,339,6023,3448,77,Domestic,6,2016-01-24,2016-01-27,1,24,-2575,3 days,711824,626429
1797,11798,2,1,tampquote,24-01-2016,Lansing,MI,1,Dayton,OH,25-01-2016,842,566,1191,5663,60,Domestic,7,2016-01-24,2016-01-25,1,24,4472,1 days,717487,627620
1502,11503,2,4,hottaxon,24-01-2016,Northbrook,IL,3,Naperville,IL,27-01-2016,1131,627,6380,3873,75,Domestic,3,2016-01-24,2016-01-27,1,24,-2507,3 days,721360,634000
1309,11310,3,2,Matsanice,24-01-2016,Green Bay,WI,10,Joliet,IL,03-02-2016,359,359,2431,2898,83,International,8,2016-01-24,2016-02-03,1,24,467,10 days,724258,636431
296,10297,2,7,Subdrill,24-01-2016,Northbrook,IL,3,Naperville,IL,27-01-2016,906,546,5843,6388,90,Domestic,10,2016-01-24,2016-01-27,1,24,545,3 days,730646,642274
763,10764,2,6,Mediaware,24-01-2016,Appleton,WI,1,Grand Rapids,MI,25-01-2016,686,650,8272,8527,62,Intercom,2,2016-01-24,2016-01-25,1,24,255,1 days,739173,650546
456,10457,2,4,Zerlane,24-01-2016,Green Bay,WI,4,Joliet,IL,28-01-2016,672,376,3644,1560,84,Domestic,4,2016-01-24,2016-01-28,1,24,-2084,4 days,740733,654190
1641,11642,3,5,Faxron,24-01-2016,Rockford,IL,8,Green Bay,WI,21-03-2016,790,501,7970,8413,89,International,1,2016-01-24,2016-03-21,1,24,443,57 days,749146,662160
1310,11311,3,5,Ronplanet,25-01-2016,Naperville,IL,7,Indianapolis,IN,01-02-2016,578,578,983,1927,90,International,3,2016-01-25,2016-02-01,1,25,944,7 days,751073,663143
879,10880,1,2,Iselectrics,25-01-2016,Bangor,MI,6,Davenport,IA,29-01-2016,936,237,7156,7730,85,International,5,2016-01-25,2016-01-29,1,25,574,4 days,758803,670299
1717,11718,2,3,Saltfan,25-01-2016,Northbrook,IL,2,Naperville,IL,27-01-2016,753,753,6291,6399,96,Domestic,3,2016-01-25,2016-01-27,1,25,108,2 days,765202,676590
1566,11567,2,3,Dongbiolex,25-01-2016,Davenport,IA,3,Appleton,WI,28-01-2016,518,452,3772,4508,82,Domestic,8,2016-01-25,2016-01-28,1,25,736,3 days,769710,680362
1238,11239,3,1,Sanlab,25-01-2016,Northbrook,IL,10,Naperville,IL,21-03-2016,744,287,307,4599,75,International,4,2016-01-25,2016-03-21,1,25,4292,56 days,774309,680669
437,10438,1,6,Warelane,25-01-2016,Rockford,IL,5,Green Bay,WI,21-03-2016,929,224,5997,6181,60,International,6,2016-01-25,2016-03-21,1,25,184,56 days,780490,686666
141,10142,2,5,Faxotfind,25-01-2016,Elgin,IL,2,Cincinnati,OH,27-01-2016,753,628,1233,1748,86,Domestic,7,2016-01-25,2016-01-27,1,25,515,2 days,782238,687899
423,10424,2,5,Joyancom,25-01-2016,Kalamazoo,MI,7,Bangor,MI,31-01-2016,487,426,2111,2450,63,International,3,2016-01-25,2016-01-31,1,25,339,6 days,784688,690010
103,10104,2,6,Streetplus,25-01-2016,Milwaukee,WI,1,Springfield,IL,26-01-2016,787,539,976,1431,86,Domestic,7,2016-01-25,2016-01-26,1,25,455,1 days,786119,690986
486,10487,1,8,D-quadlux,25-01-2016,Bangor,MI,1,Davenport,IA,26-01-2016,1036,476,1973,2570,77,Domestic,7,2016-01-25,2016-01-26,1,25,597,1 days,788689,692959
1596,11597,2,2,Quotefix,25-01-2016,Naperville,IL,1,Indianapolis,IN,27-01-2016,496,496,3520,4402,56,Domestic,5,2016-01-25,2016-01-27,1,25,882,2 days,793091,696479
1026,11027,3,5,Kantone,26-01-2016,Appleton,WI,2,Grand Rapids,MI,28-01-2016,1197,628,5634,6475,70,Domestic,6,2016-01-26,2016-01-28,1,26,841,2 days,799566,702113
909,10910,1,5,scotquote,26-01-2016,Springfield,IL,10,Skokie,IL,05-02-2016,1086,417,3793,3937,62,International,10,2016-01-26,2016-02-05,1,26,144,10 days,803503,705906
920,10921,3,4,Zerfax,26-01-2016,Rockford,IL,1,Green Bay,WI,27-01-2016,354,240,2661,650,66,Domestic,6,2016-01-26,2016-01-27,1,26,-2011,1 days,804153,708567
1473,11474,2,2,tinron,26-01-2016,Skokie,IL,8,Chicago,IL,03-02-2016,1195,798,8303,8437,61,International,6,2016-01-26,2016-02-03,1,26,134,8 days,812590,716870
1691,11692,2,6,Fasezoomfix,26-01-2016,Springfield,IL,1,Skokie,IL,27-01-2016,835,724,4951,5165,69,Intercom,4,2016-01-26,2016-01-27,1,26,214,1 days,817755,721821
560,10561,1,4,Blue-tech,26-01-2016,Joliet,IL,9,Madison,WI,04-02-2016,1046,572,6916,5265,58,International,10,2016-01-26,2016-02-04,1,26,-1651,9 days,823020,728737
981,10982,3,6,Ranmedia,26-01-2016,Rockford,IL,10,Green Bay,WI,21-03-2016,486,441,3385,3826,75,International,9,2016-01-26,2016-03-21,1,26,441,55 days,826846,732122
1245,11246,3,5,Zoodrill,26-01-2016,Naperville,IL,2,Indianapolis,IN,27-01-2016,410,410,3532,4469,83,Domestic,6,2016-01-26,2016-01-27,1,26,937,1 days,831315,735654
575,10576,1,5,Donware,27-01-2016,Davenport,IA,1,Appleton,WI,28-01-2016,1003,621,7184,7988,51,Domestic,1,2016-01-27,2016-01-28,1,27,804,1 days,839303,742838
809,10810,2,6,ganz-is,27-01-2016,Toledo,OH,1,Detriot,MI,28-01-2016,1145,318,3311,3714,86,Domestic,9,2016-01-27,2016-01-28,1,27,403,1 days,843017,746149
1046,11047,2,2,Lexidom,27-01-2016,Appleton,WI,2,Grand Rapids,MI,29-01-2016,521,415,5416,6096,68,Domestic,9,2016-01-27,2016-01-29,1,27,680,2 days,849113,751565
1330,11331,2,2,Y-flex,27-01-2016,Green Bay,WI,3,Joliet,IL,30-01-2016,909,723,1028,1927,65,Domestic,9,2016-01-27,2016-01-30,1,27,899,3 days,851040,752593
681,10682,1,7,Beta-ron,27-01-2016,Toledo,OH,3,Detriot,MI,30-01-2016,328,328,5351,5616,82,Domestic,3,2016-01-27,2016-01-30,1,27,265,3 days,856656,757944
925,10926,2,2,Whitefan,27-01-2016,Lansing,MI,1,Dayton,OH,28-01-2016,1145,429,4147,4614,97,Domestic,5,2016-01-27,2016-01-28,1,27,467,1 days,861270,762091
633,10634,1,5,dripkix,27-01-2016,Rockford,IL,6,Green Bay,WI,02-02-2016,966,790,5938,6216,52,International,10,2016-01-27,2016-02-02,1,27,278,6 days,867486,768029
62,10063,2,4,Kincorporation,28-01-2016,Milwaukee,WI,7,Springfield,IL,21-03-2016,239,239,2315,581,58,International,6,2016-01-28,2016-03-21,1,28,-1734,53 days,868067,770344
1786,11787,2,6,Howtaxon,28-01-2016,Gary,IN,4,Milwaukee,WI,01-02-2016,796,664,6271,6537,79,Domestic,6,2016-01-28,2016-02-01,1,28,266,4 days,874604,776615
1481,11482,3,6,Funfintech,28-01-2016,Detriot,MI,10,Monon,IN,04-02-2016,984,267,3707,4431,97,International,1,2016-01-28,2016-02-04,1,28,724,7 days,879035,780322
1527,11528,3,3,Sanin,28-01-2016,Detriot,MI,1,Monon,IN,29-01-2016,885,241,3219,4213,82,Domestic,1,2016-01-28,2016-01-29,1,28,994,1 days,883248,783541
1564,11565,3,6,mathtouch,28-01-2016,Skokie,IL,3,Chicago,IL,31-01-2016,539,453,6412,7314,90,Domestic,9,2016-01-28,2016-01-31,1,28,902,3 days,890562,789953
1096,11097,3,3,hexzim,28-01-2016,Skokie,IL,1,Chicago,IL,29-01-2016,923,745,4244,5195,54,Domestic,5,2016-01-28,2016-01-29,1,28,951,1 days,895757,794197
803,10804,2,4,Latgotrax,28-01-2016,Monon,IN,4,Lansing,MI,01-02-2016,905,681,7668,5557,75,Domestic,2,2016-01-28,2016-02-01,1,28,-2111,4 days,901314,801865
819,10820,1,4,Saltfan,28-01-2016,Northbrook,IL,4,Naperville,IL,01-02-2016,443,443,8192,5819,77,Domestic,1,2016-01-28,2016-02-01,1,28,-2373,4 days,907133,810057
1381,11382,3,4,Gravemedia,29-01-2016,Cincinnati,OH,4,Gary,IN,02-02-2016,596,354,7012,5576,69,Domestic,9,2016-01-29,2016-02-02,1,29,-1436,4 days,912709,817069
35,10036,2,8,Canemedkix,29-01-2016,Toledo,OH,4,Detriot,MI,02-02-2016,455,455,938,1747,89,Domestic,1,2016-01-29,2016-02-02,1,29,809,4 days,914456,818007
847,10848,2,6,Condexon,29-01-2016,Monon,IN,2,Lansing,MI,31-01-2016,1196,586,4547,4794,85,Domestic,8,2016-01-29,2016-01-31,1,29,247,2 days,919250,822554
1145,11146,2,2,Canphase,29-01-2016,Chicago,IL,2,Rockford,IL,31-01-2016,1181,789,6685,7441,94,Domestic,7,2016-01-29,2016-01-31,1,29,756,2 days,926691,829239
810,10811,2,8,Sonbam,29-01-2016,Lansing,MI,2,Dayton,OH,31-01-2016,658,658,5247,5410,72,Domestic,1,2016-01-29,2016-01-31,1,29,163,2 days,932101,834486
1017,11018,2,6,D-zohex,29-01-2016,Northbrook,IL,8,Naperville,IL,21-03-2016,831,490,8449,8791,51,International,6,2016-01-29,2016-03-21,1,29,342,52 days,940892,842935
618,10619,1,4,Zerfax,29-01-2016,Skokie,IL,6,Chicago,IL,21-03-2016,658,220,3484,1257,61,International,1,2016-01-29,2016-03-21,1,29,-2227,52 days,942149,846419
1162,11163,3,4,Coneranron,29-01-2016,Elgin,IL,6,Cincinnati,OH,04-02-2016,352,352,6181,5026,72,International,8,2016-01-29,2016-02-04,1,29,-1155,6 days,947175,852600
142,10143,1,7,Warelane,29-01-2016,Skokie,IL,1,Chicago,IL,30-01-2016,204,204,2931,3392,58,Domestic,1,2016-01-29,2016-01-30,1,29,461,1 days,950567,855531
1036,11037,3,2,Singlejob,30-01-2016,Chicago,IL,4,Rockford,IL,03-02-2016,881,534,5346,5669,89,Domestic,3,2016-01-30,2016-02-03,1,30,323,4 days,956236,860877
613,10614,1,6,Duodax,30-01-2016,Dayton,OH,2,Elgin,IL,31-01-2016,1048,244,3554,4527,71,Domestic,9,2016-01-30,2016-01-31,1,30,973,1 days,960763,864431
995,10996,2,2,Dripvivadex,30-01-2016,Northbrook,IL,6,Naperville,IL,05-02-2016,345,214,8526,8735,68,International,10,2016-01-30,2016-02-05,1,30,209,6 days,969498,872957
250,10251,1,4,Canphase,30-01-2016,Chicago,IL,8,Rockford,IL,07-02-2016,1103,565,7517,5013,99,International,3,2016-01-30,2016-02-07,1,30,-2504,8 days,974511,880474
974,10975,3,6,Duo-fase,30-01-2016,Detriot,MI,4,Monon,IN,03-02-2016,306,306,266,1168,78,Domestic,8,2016-01-30,2016-02-03,1,30,902,4 days,975679,880740
1677,11678,3,1,Alphafan,31-01-2016,Madison,WI,9,Kalamazoo,MI,07-02-2016,378,378,4135,8022,77,International,7,2016-01-31,2016-02-07,1,31,3887,7 days,983701,884875
680,10681,1,8,Funlax,31-01-2016,Dayton,OH,2,Elgin,IL,01-02-2016,1070,738,7240,7594,86,Domestic,1,2016-01-31,2016-02-01,1,31,354,1 days,991295,892115
778,10779,1,4,Toncode,31-01-2016,Northbrook,IL,10,Naperville,IL,10-02-2016,926,648,7163,5205,60,International,6,2016-01-31,2016-02-10,1,31,-1958,10 days,996500,899278
30,10031,2,7,Cannamcon,31-01-2016,Naperville,IL,2,Indianapolis,IN,02-02-2016,508,321,3102,3655,54,Domestic,2,2016-01-31,2016-02-02,1,31,553,2 days,1000155,902380
1332,11333,2,6,Warelane,31-01-2016,Rockford,IL,1,Green Bay,WI,01-02-2016,1040,570,8329,8594,59,Domestic,9,2016-01-31,2016-02-01,1,31,265,1 days,1008749,910709
595,10596,1,4,Subdrill,31-01-2016,Skokie,IL,5,Chicago,IL,05-02-2016,1065,488,5196,3360,84,International,1,2016-01-31,2016-02-05,1,31,-1836,5 days,1012109,915905
796,10797,1,7,Fasezoomfix,01-02-2016,Springfield,IL,8,Skokie,IL,09-02-2016,1192,663,3722,4657,85,International,7,2016-02-01,2016-02-09,2,1,935,8 days,1016766,919627
40,10041,2,5,Groovestrip,01-02-2016,Grand Rapids,MI,2,Toledo,OH,02-02-2016,331,331,6801,7218,83,Domestic,1,2016-02-01,2016-02-02,2,1,417,1 days,1023984,926428
1050,11051,2,3,Zerlane,01-02-2016,Bangor,MI,10,Davenport,IA,11-02-2016,1189,708,6042,6971,59,International,9,2016-02-01,2016-02-11,2,1,929,10 days,1030955,932470
14,10015,2,7,Trio-dax,01-02-2016,Dayton,OH,4,Elgin,IL,05-02-2016,732,620,3876,4471,65,Domestic,1,2016-02-01,2016-02-05,2,1,595,4 days,1035426,936346
1072,11073,2,1,conestreet,01-02-2016,Elgin,IL,2,Cincinnati,OH,03-02-2016,228,228,7542,11550,92,Domestic,6,2016-02-01,2016-02-03,2,1,4008,2 days,1046976,943888
1728,11729,3,1,Daltron,01-02-2016,Lansing,MI,2,Dayton,OH,03-02-2016,295,201,4503,9231,58,Intercom,4,2016-02-01,2016-02-03,2,1,4728,2 days,1056207,948391
364,10365,1,5,Iceelectrics,01-02-2016,Madison,WI,8,Kalamazoo,MI,08-02-2016,450,341,8253,8504,60,International,8,2016-02-01,2016-02-08,2,1,251,7 days,1064711,956644
1280,11281,3,2,Fin-cone,02-02-2016,Indianapolis,IN,2,Northbrook,IL,03-02-2016,503,503,6981,7485,94,Domestic,5,2016-02-02,2016-02-03,2,2,504,1 days,1072196,963625
775,10776,2,8,Fixcan,02-02-2016,Springfield,IL,3,Skokie,IL,05-02-2016,555,555,4968,5227,96,Domestic,6,2016-02-02,2016-02-05,2,2,259,3 days,1077423,968593
1122,11123,2,6,Warecity,02-02-2016,Springfield,IL,7,Skokie,IL,09-02-2016,875,518,6056,6354,84,International,6,2016-02-02,2016-02-09,2,2,298,7 days,1083777,974649
1446,11447,3,5,una-phase,02-02-2016,Dayton,OH,2,Elgin,IL,03-02-2016,278,278,749,1211,54,Domestic,4,2016-02-02,2016-02-03,2,2,462,1 days,1084988,975398
394,10395,1,6,Whitekix,02-02-2016,Dayton,OH,3,Elgin,IL,03-02-2016,1006,307,3990,4829,92,Domestic,3,2016-02-02,2016-02-03,2,2,839,1 days,1089817,979388
1296,11297,3,3,Trustcorporation,03-02-2016,Kalamazoo,MI,10,Bangor,MI,10-02-2016,1147,750,6228,6712,62,International,3,2016-02-03,2016-02-10,2,3,484,7 days,1096529,985616
365,10366,2,8,Vaiazoom,03-02-2016,Green Bay,WI,5,Joliet,IL,07-02-2016,671,480,1819,2109,68,International,4,2016-02-03,2016-02-07,2,3,290,4 days,1098638,987435
1038,11039,3,5,Faxron,03-02-2016,Northbrook,IL,3,Naperville,IL,06-02-2016,493,493,851,1228,97,Domestic,6,2016-02-03,2016-02-06,2,3,377,3 days,1099866,988286
1051,11052,2,4,Fixace,03-02-2016,Elgin,IL,10,Cincinnati,OH,13-02-2016,769,629,4680,2901,67,International,9,2016-02-03,2016-02-13,2,3,-1779,10 days,1102767,992966
1269,11270,2,6,Gravetech,03-02-2016,Dayton,OH,1,Elgin,IL,03-02-2016,486,486,8196,8589,81,Domestic,6,2016-02-03,2016-02-03,2,3,393,0 days,1111356,1001162
360,10361,2,8,Zimity,03-02-2016,Detriot,MI,2,Monon,IN,05-02-2016,1027,210,3246,3480,71,Intercom,5,2016-02-03,2016-02-05,2,3,234,2 days,1114836,1004408
722,10723,2,8,D-zohex,03-02-2016,Rockford,IL,3,Green Bay,WI,06-02-2016,1069,561,427,859,84,Domestic,2,2016-02-03,2016-02-06,2,3,432,3 days,1115695,1004835
1696,11697,3,6,Plexlamway,03-02-2016,Joliet,IL,1,Madison,WI,03-02-2016,885,599,6876,6995,66,Domestic,4,2016-02-03,2016-02-03,2,3,119,0 days,1122690,1011711
159,10160,1,7,Saokeycane,03-02-2016,Dayton,OH,3,Elgin,IL,06-02-2016,262,262,2650,3413,80,Domestic,1,2016-02-03,2016-02-06,2,3,763,3 days,1126103,1014361
1539,11540,3,2,Zuntexon,03-02-2016,Lansing,MI,9,Dayton,OH,11-02-2016,755,407,1903,2597,54,International,10,2016-02-03,2016-02-11,2,3,694,8 days,1128700,1016264
1709,11710,3,2,Sonzamace,03-02-2016,Skokie,IL,5,Chicago,IL,21-03-2016,905,571,2414,2663,99,International,2,2016-02-03,2016-03-21,2,3,249,47 days,1131363,1018678
1569,11570,2,2,Iceelectrics,03-02-2016,Springfield,IL,7,Skokie,IL,12-02-2016,1150,274,6734,7057,71,International,3,2016-02-03,2016-02-12,2,3,323,9 days,1138420,1025412
353,10354,2,7,roundphase,04-02-2016,Davenport,IA,1,Appleton,WI,05-02-2016,322,315,3471,3942,96,Domestic,7,2016-02-04,2016-02-05,2,4,471,1 days,1142362,1028883
523,10524,1,8,Saltfan,04-02-2016,Rockford,IL,6,Green Bay,WI,10-02-2016,955,280,131,835,92,International,3,2016-02-04,2016-02-10,2,4,704,6 days,1143197,1029014
883,10884,1,4,Latcore,04-02-2016,Davenport,IA,3,Appleton,WI,07-02-2016,470,470,3411,1098,51,Domestic,5,2016-02-04,2016-02-07,2,4,-2313,3 days,1144295,1032425
92,10093,1,7,Trueplus,04-02-2016,Appleton,WI,5,Grand Rapids,MI,09-02-2016,607,525,2872,3445,77,International,2,2016-02-04,2016-02-09,2,4,573,5 days,1147740,1035297
1212,11213,3,6,Duodax,04-02-2016,Grand Rapids,MI,4,Toledo,OH,08-02-2016,481,284,2100,3021,57,Domestic,8,2016-02-04,2016-02-08,2,4,921,4 days,1150761,1037397
1650,11651,3,3,Saokeycane,04-02-2016,Grand Rapids,MI,3,Toledo,OH,07-02-2016,888,204,5985,6200,60,Domestic,2,2016-02-04,2016-02-07,2,4,215,3 days,1156961,1043382
1326,11327,3,2,Treedrill,04-02-2016,Gary,IN,8,Milwaukee,WI,12-02-2016,810,212,237,1086,55,International,8,2016-02-04,2016-02-12,2,4,849,8 days,1158047,1043619
155,10156,2,4,techmedia,04-02-2016,Naperville,IL,2,Indianapolis,IN,04-02-2016,832,439,5441,4106,92,Domestic,9,2016-02-04,2016-02-04,2,4,-1335,0 days,1162153,1049060
1347,11348,3,1,techmedia,04-02-2016,Indianapolis,IN,6,Northbrook,IL,10-02-2016,1070,572,2398,6682,71,International,5,2016-02-04,2016-02-10,2,4,4284,6 days,1168835,1051458
477,10478,1,4,Medcan,05-02-2016,Monon,IN,2,Lansing,MI,07-02-2016,330,330,3747,1385,68,Domestic,7,2016-02-05,2016-02-07,2,5,-2362,2 days,1170220,1055205
1042,11043,2,1,planetron,05-02-2016,Monon,IN,2,Lansing,MI,07-02-2016,1018,349,3826,7485,73,Domestic,2,2016-02-05,2016-02-07,2,5,3659,2 days,1177705,1059031
1532,11533,3,1,Yearlex,05-02-2016,Green Bay,WI,8,Joliet,IL,16-02-2016,612,389,8117,12877,64,International,2,2016-02-05,2016-02-16,2,5,4760,11 days,1190582,1067148
1128,11129,3,2,dan-high,05-02-2016,Joliet,IL,2,Madison,WI,07-02-2016,772,660,4336,4985,94,Domestic,3,2016-02-05,2016-02-07,2,5,649,2 days,1195567,1071484
71,10072,1,8,Dongbiolex,05-02-2016,Cincinnati,OH,2,Gary,IN,07-02-2016,477,477,6643,7155,79,Domestic,1,2016-02-05,2016-02-07,2,5,512,2 days,1202722,1078127
1115,11116,3,2,hat-core,06-02-2016,Lansing,MI,4,Dayton,OH,10-02-2016,784,410,5982,6723,66,Domestic,9,2016-02-06,2016-02-10,2,6,741,4 days,1209445,1084109
1293,11294,2,3,Constreet,06-02-2016,Bangor,MI,4,Davenport,IA,10-02-2016,251,251,7778,8471,76,Domestic,6,2016-02-06,2016-02-10,2,6,693,4 days,1217916,1091887
872,10873,1,3,Viacane,06-02-2016,Green Bay,WI,7,Joliet,IL,13-02-2016,864,784,7594,7841,98,International,9,2016-02-06,2016-02-13,2,6,247,7 days,1225757,1099481
1292,11293,3,1,K-antex,06-02-2016,Lansing,MI,1,Dayton,OH,07-02-2016,283,283,2048,6750,95,Intercom,3,2016-02-06,2016-02-07,2,6,4702,1 days,1232507,1101529
34,10035,2,5,Zoncone,06-02-2016,Dayton,OH,3,Elgin,IL,07-02-2016,463,307,7272,8119,99,Domestic,5,2016-02-06,2016-02-07,2,6,847,1 days,1240626,1108801
72,10073,1,6,geofind,06-02-2016,Toledo,OH,5,Detriot,MI,11-02-2016,627,381,7974,8470,69,International,9,2016-02-06,2016-02-11,2,6,496,5 days,1249096,1116775
396,10397,1,4,K-antex,07-02-2016,Lansing,MI,7,Dayton,OH,14-02-2016,706,436,5614,3693,72,International,4,2016-02-07,2016-02-14,2,7,-1921,7 days,1252789,1122389
549,10550,2,6,Jaydox,07-02-2016,Skokie,IL,3,Chicago,IL,10-02-2016,373,207,6861,7110,67,Domestic,6,2016-02-07,2016-02-10,2,7,249,3 days,1259899,1129250
1063,11064,2,5,Canecare,07-02-2016,Joliet,IL,2,Madison,WI,09-02-2016,588,588,6170,6843,78,Domestic,10,2016-02-07,2016-02-09,2,7,673,2 days,1266742,1135420
897,10898,2,4,Conzumzap,07-02-2016,Appleton,WI,5,Grand Rapids,MI,11-02-2016,986,518,8523,6370,92,International,5,2016-02-07,2016-02-11,2,7,-2153,4 days,1273112,1143943
1781,11782,3,6,Plustax,07-02-2016,Milwaukee,WI,9,Springfield,IL,16-02-2016,1200,485,2583,2985,76,International,7,2016-02-07,2016-02-16,2,7,402,9 days,1276097,1146526
1324,11325,3,6,Flexplex,07-02-2016,Chicago,IL,3,Rockford,IL,10-02-2016,389,389,1604,2012,86,Domestic,7,2016-02-07,2016-02-10,2,7,408,3 days,1278109,1148130
236,10237,2,7,Y-strip,07-02-2016,Green Bay,WI,4,Joliet,IL,11-02-2016,313,313,4053,4515,99,Domestic,5,2016-02-07,2016-02-11,2,7,462,4 days,1282624,1152183
161,10162,2,7,Zerlane,07-02-2016,Bangor,MI,2,Davenport,IA,09-02-2016,809,555,1754,2692,52,Domestic,9,2016-02-07,2016-02-09,2,7,938,2 days,1285316,1153937
1707,11708,3,3,Freebam,07-02-2016,Bangor,MI,6,Davenport,IA,13-02-2016,532,532,6509,7131,98,International,3,2016-02-07,2016-02-13,2,7,622,6 days,1292447,1160446
220,10221,1,7,Statway,08-02-2016,Dayton,OH,4,Elgin,IL,12-02-2016,1005,461,157,527,87,Domestic,6,2016-02-08,2016-02-12,2,8,370,4 days,1292974,1160603
757,10758,1,7,Daltcare,08-02-2016,Joliet,IL,2,Madison,WI,09-02-2016,746,377,11,706,50,Domestic,2,2016-02-08,2016-02-09,2,8,695,1 days,1293680,1160614
1152,11153,3,5,Vivazim,08-02-2016,Madison,WI,2,Kalamazoo,MI,10-02-2016,999,321,2628,2971,83,Domestic,6,2016-02-08,2016-02-10,2,8,343,2 days,1296651,1163242
1130,11131,2,4,Daltron,08-02-2016,Madison,WI,8,Kalamazoo,MI,15-02-2016,601,566,4722,2547,79,International,7,2016-02-08,2016-02-15,2,8,-2175,7 days,1299198,1167964
1525,11526,3,3,Xx-dotone,08-02-2016,Indianapolis,IN,3,Northbrook,IL,13-02-2016,1001,438,5705,6356,64,Domestic,8,2016-02-08,2016-02-13,2,8,651,5 days,1305554,1173669
1749,11750,3,3,villahouse,08-02-2016,Dayton,OH,4,Elgin,IL,12-02-2016,1036,770,5733,6203,72,Domestic,9,2016-02-08,2016-02-12,2,8,470,4 days,1311757,1179402
564,10565,2,4,Coneranron,08-02-2016,Naperville,IL,2,Indianapolis,IN,10-02-2016,1175,724,8072,5901,95,Domestic,6,2016-02-08,2016-02-10,2,8,-2171,2 days,1317658,1187474
1097,11098,3,3,Scotlex,08-02-2016,Kalamazoo,MI,3,Bangor,MI,11-02-2016,799,799,4013,4545,69,Domestic,10,2016-02-08,2016-02-11,2,8,532,3 days,1322203,1191487
599,10600,2,4,Ventocore,08-02-2016,Milwaukee,WI,10,Springfield,IL,21-03-2016,523,336,3326,1979,92,International,8,2016-02-08,2016-03-21,2,8,-1347,42 days,1324182,1194813
502,10503,1,4,Good-find,09-02-2016,Cincinnati,OH,2,Gary,IN,11-02-2016,740,452,4053,1512,65,Domestic,8,2016-02-09,2016-02-11,2,9,-2541,2 days,1325694,1198866
1061,11062,2,4,Mediaware,09-02-2016,Detriot,MI,2,Monon,IN,11-02-2016,1045,297,7152,5420,89,Domestic,2,2016-02-09,2016-02-11,2,9,-1732,2 days,1331114,1206018
1513,11514,3,5,Duodax,09-02-2016,Dayton,OH,9,Elgin,IL,19-02-2016,1076,759,6245,6383,84,International,5,2016-02-09,2016-02-19,2,9,138,10 days,1337497,1212263
785,10786,1,8,wareholding,09-02-2016,Rockford,IL,2,Green Bay,WI,11-02-2016,1010,756,4534,5415,60,Domestic,8,2016-02-09,2016-02-11,2,9,881,2 days,1342912,1216797
126,10127,2,8,Zapline,09-02-2016,Chicago,IL,1,Rockford,IL,10-02-2016,315,315,6544,7396,61,Domestic,6,2016-02-09,2016-02-10,2,9,852,1 days,1350308,1223341
1742,11743,2,6,Condexon,10-02-2016,Monon,IN,10,Lansing,MI,20-02-2016,579,522,2728,3703,91,International,10,2016-02-10,2016-02-20,2,10,975,10 days,1354011,1226069
637,10638,2,6,zoofan,10-02-2016,Toledo,OH,10,Detriot,MI,21-03-2016,417,321,3831,4804,75,International,6,2016-02-10,2016-03-21,2,10,973,40 days,1358815,1229900
893,10894,2,6,Dentocity,10-02-2016,Madison,WI,1,Kalamazoo,MI,11-02-2016,755,205,3664,4519,81,Intercom,4,2016-02-10,2016-02-11,2,10,855,1 days,1363334,1233564
83,10084,1,4,Zamholdings,10-02-2016,Northbrook,IL,3,Naperville,IL,13-02-2016,1077,361,4421,2824,63,Domestic,3,2016-02-10,2016-02-13,2,10,-1597,3 days,1366158,1237985
1025,11026,3,2,Cityis,11-02-2016,Rockford,IL,2,Green Bay,WI,13-02-2016,903,214,7230,7444,56,Domestic,9,2016-02-11,2016-02-13,2,11,214,2 days,1373602,1245215
438,10439,1,5,Hexunobam,11-02-2016,Appleton,WI,2,Grand Rapids,MI,13-02-2016,784,731,198,1187,89,Intercom,10,2016-02-11,2016-02-13,2,11,989,2 days,1374789,1245413
574,10575,2,5,Canace,11-02-2016,Kalamazoo,MI,4,Bangor,MI,15-02-2016,245,245,3100,3591,62,Domestic,10,2016-02-11,2016-02-15,2,11,491,4 days,1378380,1248513
905,10906,2,2,Keyzunbase,11-02-2016,Kalamazoo,MI,2,Bangor,MI,13-02-2016,887,410,4731,4967,55,Domestic,8,2016-02-11,2016-02-13,2,11,236,2 days,1383347,1253244
1723,11724,3,2,Streetlam,11-02-2016,Rockford,IL,9,Green Bay,WI,20-02-2016,434,310,2653,3131,97,International,2,2016-02-11,2016-02-20,2,11,478,9 days,1386478,1255897
742,10743,2,6,Faseron,11-02-2016,Appleton,WI,9,Grand Rapids,MI,20-02-2016,1086,336,6975,7112,66,International,4,2016-02-11,2016-02-20,2,11,137,9 days,1393590,1262872
300,10301,1,4,tampquote,11-02-2016,Madison,WI,2,Kalamazoo,MI,13-02-2016,862,494,4827,3015,65,Domestic,2,2016-02-11,2016-02-13,2,11,-1812,2 days,1396605,1267699
450,10451,1,8,techmedia,12-02-2016,Indianapolis,IN,2,Northbrook,IL,12-02-2016,897,691,4174,4316,50,Domestic,4,2016-02-12,2016-02-12,2,12,142,0 days,1400921,1271873
1284,11285,3,6,roundphase,12-02-2016,Joliet,IL,1,Madison,WI,13-02-2016,796,300,479,1401,79,Domestic,6,2016-02-12,2016-02-13,2,12,922,1 days,1402322,1272352
1299,11300,3,1,Duoflex,12-02-2016,Milwaukee,WI,1,Springfield,IL,13-02-2016,905,782,7305,11509,50,Domestic,10,2016-02-12,2016-02-13,2,12,4204,1 days,1413831,1279657
774,10775,1,8,Medcan,12-02-2016,Milwaukee,WI,1,Springfield,IL,13-02-2016,1101,414,7752,8520,50,Domestic,1,2016-02-12,2016-02-13,2,12,768,1 days,1422351,1287409
683,10684,2,8,Fin-cone,12-02-2016,Elgin,IL,4,Cincinnati,OH,16-02-2016,976,484,830,1487,73,Domestic,7,2016-02-12,2016-02-16,2,12,657,4 days,1423838,1288239
686,10687,2,8,Templax,12-02-2016,Davenport,IA,1,Appleton,WI,13-02-2016,690,223,7808,8502,85,Domestic,2,2016-02-12,2016-02-13,2,12,694,1 days,1432340,1296047
357,10358,2,8,Scotfase,12-02-2016,Chicago,IL,5,Rockford,IL,17-02-2016,1019,218,2705,3556,52,International,10,2016-02-12,2016-02-17,2,12,851,5 days,1435896,1298752
1807,11808,3,6,Dingity,12-02-2016,Detriot,MI,10,Monon,IN,19-02-2016,721,619,1000,1362,68,International,7,2016-02-12,2016-02-19,2,12,362,7 days,1437258,1299752
890,10891,1,6,Howtaxon,13-02-2016,Gary,IN,6,Milwaukee,WI,19-02-2016,782,270,3184,3743,62,International,7,2016-02-13,2016-02-19,2,13,559,6 days,1441001,1302936
1049,11050,2,5,Inzone,13-02-2016,Lansing,MI,9,Dayton,OH,22-02-2016,986,450,1024,1194,55,International,6,2016-02-13,2016-02-22,2,13,170,9 days,1442195,1303960
807,10808,1,6,Unatrax,13-02-2016,Cincinnati,OH,4,Gary,IN,17-02-2016,429,429,1810,2373,84,Domestic,3,2016-02-13,2016-02-17,2,13,563,4 days,1444568,1305770
596,10597,1,8,Conzumzap,13-02-2016,Kalamazoo,MI,7,Bangor,MI,20-02-2016,766,233,1075,1792,96,International,9,2016-02-13,2016-02-20,2,13,717,7 days,1446360,1306845
1523,11524,2,4,Whitefan,14-02-2016,Springfield,IL,3,Skokie,IL,17-02-2016,756,711,8591,6237,59,Domestic,6,2016-02-14,2016-02-17,2,14,-2354,3 days,1452597,1315436
1163,11164,3,6,zen-holdings,14-02-2016,Skokie,IL,10,Chicago,IL,21-03-2016,469,469,5735,6120,67,International,2,2016-02-14,2016-03-21,2,14,385,36 days,1458717,1321171
1616,11617,2,2,Zapline,14-02-2016,Green Bay,WI,3,Joliet,IL,17-02-2016,444,255,6036,6505,53,Domestic,5,2016-02-14,2016-02-17,2,14,469,3 days,1465222,1327207
463,10464,1,4,Indibase,14-02-2016,Bangor,MI,2,Davenport,IA,16-02-2016,475,306,6559,4503,57,Domestic,8,2016-02-14,2016-02-16,2,14,-2056,2 days,1469725,1333766
1218,11219,2,2,Technoline,14-02-2016,Detriot,MI,9,Monon,IN,23-02-2016,582,582,5136,5292,82,International,6,2016-02-14,2016-02-23,2,14,156,9 days,1475017,1338902
772,10773,2,7,Indigoice,14-02-2016,Davenport,IA,4,Appleton,WI,18-02-2016,620,458,2619,2839,66,Domestic,2,2016-02-14,2016-02-18,2,14,220,4 days,1477856,1341521
123,10124,2,6,Laex,14-02-2016,Grand Rapids,MI,4,Toledo,OH,18-02-2016,773,496,8025,8752,59,Domestic,4,2016-02-14,2016-02-18,2,14,727,4 days,1486608,1349546
545,10546,2,5,una-phase,14-02-2016,Dayton,OH,2,Elgin,IL,16-02-2016,1159,507,6721,7409,59,Domestic,6,2016-02-14,2016-02-16,2,14,688,2 days,1494017,1356267
1376,11377,2,5,Medcan,14-02-2016,Monon,IN,3,Lansing,MI,17-02-2016,1067,679,4378,4843,100,Domestic,6,2016-02-14,2016-02-17,2,14,465,3 days,1498860,1360645
328,10329,2,6,Matdex,14-02-2016,Toledo,OH,3,Detriot,MI,17-02-2016,1195,570,1584,1947,72,Domestic,3,2016-02-14,2016-02-17,2,14,363,3 days,1500807,1362229
524,10525,1,5,Joygreen,15-02-2016,Appleton,WI,7,Grand Rapids,MI,22-02-2016,877,232,6466,6606,74,International,4,2016-02-15,2016-02-22,2,15,140,7 days,1507413,1368695
867,10868,1,5,Warebam,15-02-2016,Detriot,MI,4,Monon,IN,19-02-2016,500,500,2220,3166,87,Domestic,6,2016-02-15,2016-02-19,2,15,946,4 days,1510579,1370915
1253,11254,3,5,nimlab,15-02-2016,Elgin,IL,3,Cincinnati,OH,17-02-2016,1042,258,4438,5222,64,Domestic,8,2016-02-15,2016-02-17,2,15,784,2 days,1515801,1375353
1727,11728,2,5,Jobtechnology,15-02-2016,Toledo,OH,8,Detriot,MI,21-03-2016,521,521,2550,2813,55,International,3,2016-02-15,2016-03-21,2,15,263,35 days,1518614,1377903
478,10479,2,8,Dentoelectrics,15-02-2016,Green Bay,WI,7,Joliet,IL,20-02-2016,795,687,4054,4530,82,International,5,2016-02-15,2016-02-20,2,15,476,5 days,1523144,1381957
735,10736,1,6,Warelane,15-02-2016,Northbrook,IL,2,Naperville,IL,17-02-2016,1087,579,2709,3225,87,Domestic,5,2016-02-15,2016-02-17,2,15,516,2 days,1526369,1384666
1359,11360,3,2,Daltcare,15-02-2016,Dayton,OH,3,Elgin,IL,18-02-2016,381,332,5954,6751,56,Domestic,7,2016-02-15,2016-02-18,2,15,797,3 days,1533120,1390620
1541,11542,3,2,Fasezim,15-02-2016,Elgin,IL,1,Cincinnati,OH,15-02-2016,318,318,7783,8518,87,Domestic,10,2016-02-15,2016-02-15,2,15,735,0 days,1541638,1398403
1443,11444,2,2,Saocity,15-02-2016,Rockford,IL,2,Green Bay,WI,17-02-2016,1138,256,4254,4701,61,Domestic,7,2016-02-15,2016-02-17,2,15,447,2 days,1546339,1402657
1663,11664,2,1,Canecare,15-02-2016,Dayton,OH,4,Elgin,IL,18-02-2016,370,370,4747,9253,88,Domestic,1,2016-02-15,2016-02-18,2,15,4506,3 days,1555592,1407404
792,10793,1,6,Golddexon,15-02-2016,Skokie,IL,4,Chicago,IL,19-02-2016,490,490,1369,2102,90,Domestic,1,2016-02-15,2016-02-19,2,15,733,4 days,1557694,1408773
533,10534,1,6,dan-high,15-02-2016,Grand Rapids,MI,2,Toledo,OH,16-02-2016,827,513,5718,5862,88,Domestic,7,2016-02-15,2016-02-16,2,15,144,1 days,1563556,1414491
949,10950,3,6,Daltfax,16-02-2016,Davenport,IA,1,Appleton,WI,17-02-2016,1114,677,2796,3566,79,Domestic,4,2016-02-16,2016-02-17,2,16,770,1 days,1567122,1417287
237,10238,2,8,Danfan,16-02-2016,Naperville,IL,2,Indianapolis,IN,18-02-2016,207,207,2683,3245,100,Domestic,2,2016-02-16,2016-02-18,2,16,562,2 days,1570367,1419970
1524,11525,2,2,Strongdax,16-02-2016,Chicago,IL,3,Rockford,IL,19-02-2016,837,268,697,1635,78,Domestic,9,2016-02-16,2016-02-19,2,16,938,3 days,1572002,1420667
163,10164,1,8,unaity,16-02-2016,Kalamazoo,MI,6,Bangor,MI,22-02-2016,1147,399,294,553,99,International,3,2016-02-16,2016-02-22,2,16,259,6 days,1572555,1420961
1031,11032,3,5,Y-flex,16-02-2016,Bangor,MI,1,Davenport,IA,17-02-2016,778,640,3288,3975,84,Domestic,2,2016-02-16,2016-02-17,2,16,687,1 days,1576530,1424249
1387,11388,2,6,wareholding,16-02-2016,Skokie,IL,9,Chicago,IL,21-03-2016,630,341,3191,4062,63,International,7,2016-02-16,2016-03-21,2,16,871,34 days,1580592,1427440
1186,11187,3,6,Viatom,17-02-2016,Elgin,IL,3,Cincinnati,OH,20-02-2016,509,407,4671,5467,90,Domestic,5,2016-02-17,2016-02-20,2,17,796,3 days,1586059,1432111
1670,11671,2,1,Zotfan,17-02-2016,Grand Rapids,MI,1,Toledo,OH,17-02-2016,682,664,2283,6658,81,Domestic,6,2016-02-17,2016-02-17,2,17,4375,0 days,1592717,1434394
566,10567,1,8,Warebam,17-02-2016,Appleton,WI,7,Grand Rapids,MI,22-02-2016,586,586,4810,5193,92,International,4,2016-02-17,2016-02-22,2,17,383,5 days,1597910,1439204
1610,11611,2,4,Ronplanet,17-02-2016,Indianapolis,IN,1,Northbrook,IL,17-02-2016,265,265,6771,4137,71,Domestic,1,2016-02-17,2016-02-17,2,17,-2634,0 days,1602047,1445975
1412,11413,3,1,Sonbam,17-02-2016,Springfield,IL,1,Skokie,IL,18-02-2016,565,530,440,5848,57,Domestic,5,2016-02-17,2016-02-18,2,17,5408,1 days,1607895,1446415
1528,11529,3,6,Sonlex,18-02-2016,Gary,IN,2,Milwaukee,WI,20-02-2016,737,253,8103,8463,83,Domestic,1,2016-02-18,2016-02-20,2,18,360,2 days,1616358,1454518
1464,11465,2,5,Redozetam,18-02-2016,Green Bay,WI,7,Joliet,IL,22-02-2016,461,461,6233,6495,59,International,9,2016-02-18,2016-02-22,2,18,262,4 days,1622853,1460751
1343,11344,3,1,Geoit,18-02-2016,Grand Rapids,MI,3,Toledo,OH,19-02-2016,303,303,1429,6695,65,Domestic,9,2016-02-18,2016-02-19,2,18,5266,1 days,1629548,1462180
1531,11532,2,3,Saohow,18-02-2016,Madison,WI,10,Kalamazoo,MI,02-03-2016,754,752,404,559,59,International,7,2016-02-18,2016-03-02,2,18,155,13 days,1630107,1462584
1365,11366,2,4,Mediaware,18-02-2016,Kalamazoo,MI,7,Bangor,MI,25-02-2016,411,411,3335,1145,100,International,1,2016-02-18,2016-02-25,2,18,-2190,7 days,1631252,1465919
907,10908,1,6,Villacom,18-02-2016,Grand Rapids,MI,2,Toledo,OH,19-02-2016,772,217,7350,8346,79,Domestic,3,2016-02-18,2016-02-19,2,18,996,1 days,1639598,1473269
1335,11336,3,6,Opehouse,19-02-2016,Dayton,OH,3,Elgin,IL,21-02-2016,387,387,338,484,70,Domestic,2,2016-02-19,2016-02-21,2,19,146,2 days,1640082,1473607
197,10198,2,6,Inchholdings,19-02-2016,Cincinnati,OH,9,Gary,IN,28-02-2016,879,765,8478,8987,75,International,9,2016-02-19,2016-02-28,2,19,509,9 days,1649069,1482085
1570,11571,3,2,Vaiazoom,19-02-2016,Chicago,IL,9,Rockford,IL,29-02-2016,460,206,6672,7085,74,International,8,2016-02-19,2016-02-29,2,19,413,10 days,1656154,1488757
767,10768,2,4,Zerhouse,19-02-2016,Lansing,MI,10,Dayton,OH,28-02-2016,1005,206,4708,2385,62,International,4,2016-02-19,2016-02-28,2,19,-2323,9 days,1658539,1493465
932,10933,3,3,Bamtechnology,20-02-2016,Indianapolis,IN,4,Northbrook,IL,24-02-2016,1162,602,1646,2034,90,Domestic,5,2016-02-20,2016-02-24,2,20,388,4 days,1660573,1495111
1486,11487,3,1,Quotelane,20-02-2016,Green Bay,WI,2,Joliet,IL,22-02-2016,702,222,1409,5883,81,Domestic,4,2016-02-20,2016-02-22,2,20,4474,2 days,1666456,1496520
1355,11356,2,6,Fixace,20-02-2016,Naperville,IL,3,Indianapolis,IN,20-02-2016,384,384,6709,7199,79,Domestic,2,2016-02-20,2016-02-20,2,20,490,0 days,1673655,1503229
1264,11265,2,3,Vaiazoom,20-02-2016,Green Bay,WI,2,Joliet,IL,22-02-2016,411,411,1439,1547,71,Domestic,1,2016-02-20,2016-02-22,2,20,108,2 days,1675202,1504668
1340,11341,2,4,Faxron,20-02-2016,Skokie,IL,2,Chicago,IL,22-02-2016,660,378,5937,3878,78,Domestic,7,2016-02-20,2016-02-22,2,20,-2059,2 days,1679080,1510605
407,10408,1,8,Xx-planet,20-02-2016,Northbrook,IL,4,Naperville,IL,24-02-2016,321,225,6006,6913,100,Domestic,6,2016-02-20,2016-02-24,2,20,907,4 days,1685993,1516611
1661,11662,2,6,Mediaware,21-02-2016,Appleton,WI,7,Grand Rapids,MI,25-02-2016,474,474,8376,8984,69,International,10,2016-02-21,2016-02-25,2,21,608,4 days,1694977,1524987
1009,11010,2,5,Lexiplus,21-02-2016,Skokie,IL,4,Chicago,IL,25-02-2016,813,438,8472,8920,83,Domestic,7,2016-02-21,2016-02-25,2,21,448,4 days,1703897,1533459
991,10992,3,5,Streetplus,21-02-2016,Milwaukee,WI,2,Springfield,IL,23-02-2016,583,214,1934,2882,83,Domestic,5,2016-02-21,2016-02-23,2,21,948,2 days,1706779,1535393
470,10471,1,8,Zerhouse,21-02-2016,Springfield,IL,7,Skokie,IL,28-02-2016,307,307,3029,3981,91,International,3,2016-02-21,2016-02-28,2,21,952,7 days,1710760,1538422
1437,11438,2,2,Triootity,21-02-2016,Gary,IN,6,Milwaukee,WI,27-02-2016,786,281,2582,3104,86,International,3,2016-02-21,2016-02-27,2,21,522,6 days,1713864,1541004
1430,11431,3,2,Siliconcore,21-02-2016,Davenport,IA,4,Appleton,WI,25-02-2016,291,291,5801,5936,59,Domestic,6,2016-02-21,2016-02-25,2,21,135,4 days,1719800,1546805
804,10805,2,8,Scothouse,21-02-2016,Green Bay,WI,5,Joliet,IL,23-02-2016,1111,497,7277,8186,69,International,4,2016-02-21,2016-02-23,2,21,909,2 days,1727986,1554082
1543,11544,2,3,Mathing,21-02-2016,Kalamazoo,MI,3,Bangor,MI,24-02-2016,386,278,2055,2800,91,Domestic,6,2016-02-21,2016-02-24,2,21,745,3 days,1730786,1556137
252,10253,2,7,Jaydox,21-02-2016,Northbrook,IL,8,Naperville,IL,21-03-2016,976,369,1819,2450,54,International,6,2016-02-21,2016-03-21,2,21,631,29 days,1733236,1557956
1401,11402,3,5,Scotlex,22-02-2016,Appleton,WI,6,Grand Rapids,MI,28-02-2016,253,253,2142,3003,84,International,5,2016-02-22,2016-02-28,2,22,861,6 days,1736239,1560098
1758,11759,2,2,Unahigh,22-02-2016,Milwaukee,WI,2,Springfield,IL,24-02-2016,1008,729,5481,6286,66,Domestic,1,2016-02-22,2016-02-24,2,22,805,2 days,1742525,1565579
1298,11299,2,6,Scotcan,22-02-2016,Grand Rapids,MI,4,Toledo,OH,24-02-2016,992,324,2942,3674,55,Domestic,9,2016-02-22,2016-02-24,2,22,732,2 days,1746199,1568521
13,10014,2,6,ontotam,22-02-2016,Cincinnati,OH,1,Gary,IN,23-02-2016,701,701,933,1265,78,Domestic,5,2016-02-22,2016-02-23,2,22,332,1 days,1747464,1569454
725,10726,1,6,Goodquoing,22-02-2016,Toledo,OH,6,Detriot,MI,28-02-2016,702,702,4083,4244,77,International,3,2016-02-22,2016-02-28,2,22,161,6 days,1751708,1573537
1649,11650,2,4,zummatax,22-02-2016,Davenport,IA,2,Appleton,WI,24-02-2016,1119,709,3118,1422,91,Domestic,10,2016-02-22,2016-02-24,2,22,-1696,2 days,1753130,1576655
46,10047,2,6,Instrip,22-02-2016,Detriot,MI,1,Monon,IN,23-02-2016,812,535,3551,4147,94,Intercom,5,2016-02-22,2016-02-23,2,22,596,1 days,1757277,1580206
503,10504,1,5,Plexlamway,22-02-2016,Dayton,OH,4,Elgin,IL,25-02-2016,932,341,4624,4803,92,Domestic,5,2016-02-22,2016-02-25,2,22,179,3 days,1762080,1584830
1227,11228,3,1,Groovestrip,22-02-2016,Dayton,OH,4,Elgin,IL,24-02-2016,341,341,1217,6339,91,Domestic,4,2016-02-22,2016-02-24,2,22,5122,2 days,1768419,1586047
959,10960,3,3,Newzap,22-02-2016,Naperville,IL,3,Indianapolis,IN,24-02-2016,1050,680,3631,3969,99,Domestic,10,2016-02-22,2016-02-24,2,22,338,2 days,1772388,1589678
484,10485,1,8,Citytone,23-02-2016,Toledo,OH,1,Detriot,MI,24-02-2016,1190,713,5347,6099,77,Domestic,1,2016-02-23,2016-02-24,2,23,752,1 days,1778487,1595025
1714,11715,3,6,hat-core,23-02-2016,Springfield,IL,9,Skokie,IL,02-03-2016,571,555,3672,4016,55,International,9,2016-02-23,2016-03-02,2,23,344,8 days,1782503,1598697
664,10665,2,8,Zimity,23-02-2016,Kalamazoo,MI,1,Bangor,MI,24-02-2016,873,384,7386,7729,56,Domestic,10,2016-02-23,2016-02-24,2,23,343,1 days,1790232,1606083
179,10180,1,5,Medcan,23-02-2016,Toledo,OH,5,Detriot,MI,28-02-2016,400,379,3964,4854,90,International,5,2016-02-23,2016-02-28,2,23,890,5 days,1795086,1610047
1184,11185,3,1,bamity,23-02-2016,Lansing,MI,2,Dayton,OH,25-02-2016,236,236,3652,8794,94,Intercom,10,2016-02-23,2016-02-25,2,23,5142,2 days,1803880,1613699
361,10362,2,8,Dongbiolex,23-02-2016,Gary,IN,2,Milwaukee,WI,25-02-2016,1067,296,4611,5281,64,Domestic,4,2016-02-23,2016-02-25,2,23,670,2 days,1809161,1618310
1185,11186,2,4,Quotelane,23-02-2016,Bangor,MI,2,Davenport,IA,25-02-2016,1048,708,8801,6031,87,Domestic,3,2016-02-23,2016-02-25,2,23,-2770,2 days,1815192,1627111
1493,11494,3,3,Indi-dox,24-02-2016,Bangor,MI,8,Davenport,IA,05-03-2016,576,299,1075,1448,53,International,7,2016-02-24,2016-03-05,2,24,373,10 days,1816640,1628186
1157,11158,3,6,Itcantrans,24-02-2016,Cincinnati,OH,1,Gary,IN,25-02-2016,959,520,7549,8424,93,Domestic,4,2016-02-24,2016-02-25,2,24,875,1 days,1825064,1635735
1199,11200,2,5,Recode,24-02-2016,Green Bay,WI,5,Joliet,IL,29-02-2016,406,339,1483,1970,85,International,7,2016-02-24,2016-02-29,2,24,487,5 days,1827034,1637218
506,10507,1,6,Scothouse,24-02-2016,Bangor,MI,7,Davenport,IA,02-03-2016,767,677,3409,4125,99,International,9,2016-02-24,2016-03-02,2,24,716,7 days,1831159,1640627
1494,11495,2,4,Damdexon,24-02-2016,Elgin,IL,10,Cincinnati,OH,06-03-2016,391,391,2770,1131,83,International,2,2016-02-24,2016-03-06,2,24,-1639,11 days,1832290,1643397
1694,11695,3,3,Scotlex,24-02-2016,Detriot,MI,9,Monon,IN,03-03-2016,806,458,4680,5318,81,International,8,2016-02-24,2016-03-03,2,24,638,8 days,1837608,1648077
1043,11044,2,3,Stimcore,24-02-2016,Madison,WI,3,Kalamazoo,MI,27-02-2016,502,379,838,1726,64,Domestic,4,2016-02-24,2016-02-27,2,24,888,3 days,1839334,1648915
835,10836,2,5,Plustaxon,24-02-2016,Skokie,IL,8,Chicago,IL,21-03-2016,703,703,5226,5599,76,International,5,2016-02-24,2016-03-21,2,24,373,26 days,1844933,1654141
593,10594,1,5,Indi-dox,24-02-2016,Bangor,MI,2,Davenport,IA,26-02-2016,425,425,8439,8814,89,Domestic,6,2016-02-24,2016-02-26,2,24,375,2 days,1853747,1662580
1565,11566,3,2,Zimity,25-02-2016,Kalamazoo,MI,3,Bangor,MI,28-02-2016,1006,683,7695,8599,60,Domestic,2,2016-02-25,2016-02-28,2,25,904,3 days,1862346,1670275
534,10535,2,6,Jobtechnology,25-02-2016,Milwaukee,WI,2,Springfield,IL,27-02-2016,833,603,334,930,50,Domestic,4,2016-02-25,2016-02-27,2,25,596,2 days,1863276,1670609
177,10178,1,5,Indigoice,25-02-2016,Cincinnati,OH,2,Gary,IN,27-02-2016,1159,738,897,1853,68,Domestic,4,2016-02-25,2016-02-27,2,25,956,2 days,1865129,1671506
1291,11292,3,3,Streetplus,25-02-2016,Toledo,OH,8,Detriot,MI,21-03-2016,883,326,4628,5299,60,International,5,2016-02-25,2016-03-21,2,25,671,25 days,1870428,1676134
728,10729,1,5,Bluezoombam,26-02-2016,Elgin,IL,5,Cincinnati,OH,02-03-2016,609,376,3453,3926,94,International,5,2016-02-26,2016-03-02,2,26,473,5 days,1874354,1679587
825,10826,1,8,Donremlane,26-02-2016,Green Bay,WI,1,Joliet,IL,27-02-2016,916,591,6765,7258,56,Domestic,7,2016-02-26,2016-02-27,2,26,493,1 days,1881612,1686352
213,10214,2,4,acequote,26-02-2016,Joliet,IL,4,Madison,WI,28-02-2016,704,376,6635,4774,68,Domestic,10,2016-02-26,2016-02-28,2,26,-1861,2 days,1886386,1692987
69,10070,2,5,Dontam,26-02-2016,Madison,WI,1,Kalamazoo,MI,27-02-2016,1182,637,7817,8576,89,Domestic,6,2016-02-26,2016-02-27,2,26,759,1 days,1894962,1700804
1126,11127,2,1,Tonsanhigh,26-02-2016,Detriot,MI,2,Monon,IN,28-02-2016,441,353,5679,10241,52,Intercom,10,2016-02-26,2016-02-28,2,26,4562,2 days,1905203,1706483
1679,11680,2,3,Funlatlex,26-02-2016,Naperville,IL,1,Indianapolis,IN,26-02-2016,985,254,746,1526,85,Domestic,5,2016-02-26,2016-02-26,2,26,780,0 days,1906729,1707229
66,10067,2,5,roundphase,26-02-2016,Gary,IN,6,Milwaukee,WI,29-02-2016,695,617,3590,4495,73,International,1,2016-02-26,2016-02-29,2,26,905,3 days,1911224,1710819
1657,11658,3,2,Daltcare,26-02-2016,Joliet,IL,8,Madison,WI,05-03-2016,918,470,2839,3504,67,International,9,2016-02-26,2016-03-05,2,26,665,8 days,1914728,1713658
227,10228,1,4,Namelectronics,26-02-2016,Milwaukee,WI,3,Springfield,IL,29-02-2016,559,271,1751,585,54,Domestic,5,2016-02-26,2016-02-29,2,26,-1166,3 days,1915313,1715409
1360,11361,2,2,doubleis,26-02-2016,Toledo,OH,1,Detriot,MI,27-02-2016,938,422,5998,6115,84,Domestic,2,2016-02-26,2016-02-27,2,26,117,1 days,1921428,1721407
620,10621,1,4,applanet,27-02-2016,Davenport,IA,3,Appleton,WI,01-03-2016,349,349,7682,5934,58,Domestic,2,2016-02-27,2016-03-01,2,27,-1748,3 days,1927362,1729089
293,10294,2,8,Dentocity,27-02-2016,Springfield,IL,10,Skokie,IL,07-03-2016,501,501,6376,6830,100,International,8,2016-02-27,2016-03-07,2,27,454,9 days,1934192,1735465
1067,11068,3,3,Planetware,27-02-2016,Appleton,WI,9,Grand Rapids,MI,07-03-2016,461,328,1773,2015,73,International,9,2016-02-27,2016-03-07,2,27,242,9 days,1936207,1737238
298,10299,1,5,Trio-dax,27-02-2016,Joliet,IL,3,Madison,WI,01-03-2016,531,525,6577,7001,62,Domestic,8,2016-02-27,2016-03-01,2,27,424,3 days,1943208,1743815
916,10917,3,5,Planethouse,27-02-2016,Monon,IN,2,Lansing,MI,29-02-2016,755,693,6392,7120,93,Domestic,3,2016-02-27,2016-02-29,2,27,728,2 days,1950328,1750207
200,10201,1,6,Fasezoomfix,28-02-2016,Lansing,MI,2,Dayton,OH,01-03-2016,771,654,4975,5427,51,Intercom,3,2016-02-28,2016-03-01,2,28,452,2 days,1955755,1755182
1617,11618,2,3,Tamtexon,28-02-2016,Naperville,IL,2,Indianapolis,IN,29-02-2016,967,581,363,711,70,Domestic,7,2016-02-28,2016-02-29,2,28,348,1 days,1956466,1755545
663,10664,2,7,mathtouch,28-02-2016,Skokie,IL,4,Chicago,IL,03-03-2016,699,678,8014,8429,53,Domestic,10,2016-02-28,2016-03-03,2,28,415,4 days,1964895,1763559
1133,11134,3,6,Plustaxon,28-02-2016,Rockford,IL,4,Green Bay,WI,03-03-2016,721,717,8314,8586,74,Domestic,7,2016-02-28,2016-03-03,2,28,272,4 days,1973481,1771873
25,10026,2,6,Baselux,28-02-2016,Northbrook,IL,10,Naperville,IL,09-03-2016,875,247,1780,2445,70,International,8,2016-02-28,2016-03-09,2,28,665,10 days,1975926,1773653
522,10523,1,5,Subvivais,28-02-2016,Naperville,IL,2,Indianapolis,IN,29-02-2016,649,366,2655,2874,73,Domestic,6,2016-02-28,2016-02-29,2,28,219,1 days,1978800,1776308
1119,11120,2,4,Donelectrics,28-02-2016,Davenport,IA,3,Appleton,WI,02-03-2016,508,493,2674,860,73,Domestic,3,2016-02-28,2016-03-02,2,28,-1814,3 days,1979660,1778982
1624,11625,2,5,Bluezoombam,28-02-2016,Elgin,IL,4,Cincinnati,OH,03-03-2016,228,228,6603,7537,88,Domestic,9,2016-02-28,2016-03-03,2,28,934,4 days,1987197,1785585
291,10292,2,6,xx-way,28-02-2016,Grand Rapids,MI,2,Toledo,OH,01-03-2016,915,570,1595,1796,64,Domestic,3,2016-02-28,2016-03-01,2,28,201,2 days,1988993,1787180
260,10261,1,6,Conehotice,28-02-2016,Appleton,WI,2,Grand Rapids,MI,01-03-2016,807,200,863,1113,73,Domestic,1,2016-02-28,2016-03-01,2,28,250,2 days,1990106,1788043
698,10699,2,5,Quotefix,28-02-2016,Naperville,IL,2,Indianapolis,IN,29-02-2016,1038,452,2556,2858,73,Domestic,10,2016-02-28,2016-02-29,2,28,302,1 days,1992964,1790599
869,10870,1,3,Hayholding,28-02-2016,Joliet,IL,2,Madison,WI,28-02-2016,214,214,3667,3832,64,Domestic,6,2016-02-28,2016-02-28,2,28,165,0 days,1996796,1794266
1687,11688,2,6,Zunhouse,28-02-2016,Kalamazoo,MI,8,Bangor,MI,07-03-2016,1158,319,7542,7955,76,International,6,2016-02-28,2016-03-07,2,28,413,8 days,2004751,1801808
874,10875,1,6,Canace,28-02-2016,Appleton,WI,1,Grand Rapids,MI,29-02-2016,488,233,484,698,96,Intercom,3,2016-02-28,2016-02-29,2,28,214,1 days,2005449,1802292
1197,11198,2,2,Trio-dax,28-02-2016,Joliet,IL,2,Madison,WI,29-02-2016,216,216,1797,2306,71,Domestic,1,2016-02-28,2016-02-29,2,28,509,1 days,2007755,1804089
1175,11176,3,1,Tantechi,28-02-2016,Monon,IN,3,Lansing,MI,02-03-2016,1002,585,702,5415,82,Domestic,6,2016-02-28,2016-03-02,2,28,4713,3 days,2013170,1804791
1314,11315,2,2,Laex,28-02-2016,Dayton,OH,3,Elgin,IL,02-03-2016,453,341,1520,2197,71,Domestic,6,2016-02-28,2016-03-02,2,28,677,3 days,2015367,1806311
178,10179,2,8,Zotfan,29-02-2016,Dayton,OH,4,Elgin,IL,01-03-2016,550,421,6668,7405,87,Domestic,7,2016-02-29,2016-03-01,2,29,737,1 days,2022772,1812979
50,10051,2,7,Howplanet,29-02-2016,Green Bay,WI,9,Joliet,IL,06-03-2016,1130,462,6108,6863,89,International,8,2016-02-29,2016-03-06,2,29,755,6 days,2029635,1819087
587,10588,2,4,Viatom,29-02-2016,Naperville,IL,2,Indianapolis,IN,01-03-2016,947,744,5440,3358,81,Domestic,4,2016-02-29,2016-03-01,2,29,-2082,1 days,2032993,1824527
1127,11128,2,3,Siliconcore,29-02-2016,Gary,IN,1,Milwaukee,WI,01-03-2016,297,297,3948,4412,87,Domestic,1,2016-02-29,2016-03-01,2,29,464,1 days,2037405,1828475
1639,11640,3,1,Singlejob,29-02-2016,Green Bay,WI,8,Joliet,IL,08-03-2016,429,391,1918,5363,84,International,7,2016-02-29,2016-03-08,2,29,3445,8 days,2042768,1830393
1158,11159,3,3,Blue-tech,01-03-2016,Dayton,OH,3,Elgin,IL,01-03-2016,551,551,453,1165,80,Domestic,9,2016-03-01,2016-03-01,3,1,712,0 days,2043933,1830846
1397,11398,3,2,Fasezoomfix,01-03-2016,Madison,WI,1,Kalamazoo,MI,02-03-2016,213,213,2505,3498,60,Domestic,5,2016-03-01,2016-03-02,3,1,993,1 days,2047431,1833351
1630,11631,2,1,Ronvivalam,01-03-2016,Springfield,IL,3,Skokie,IL,04-03-2016,576,359,8,3710,52,Domestic,5,2016-03-01,2016-03-04,3,1,3702,3 days,2051141,1833359
215,10216,2,8,Sonbam,01-03-2016,Madison,WI,6,Kalamazoo,MI,07-03-2016,820,793,5563,5854,82,International,8,2016-03-01,2016-03-07,3,1,291,6 days,2056995,1838922
1315,11316,2,6,Tantax,01-03-2016,Toledo,OH,1,Detriot,MI,02-03-2016,518,518,4674,4931,64,Domestic,4,2016-03-01,2016-03-02,3,1,257,1 days,2061926,1843596
1635,11636,2,5,Quadplanet,01-03-2016,Gary,IN,1,Milwaukee,WI,02-03-2016,1146,473,1179,1685,94,Domestic,6,2016-03-01,2016-03-02,3,1,506,1 days,2063611,1844775
969,10970,2,2,Strongcane,02-03-2016,Milwaukee,WI,2,Springfield,IL,04-03-2016,524,524,5693,5958,99,Domestic,1,2016-03-02,2016-03-04,3,2,265,2 days,2069569,1850468
714,10715,2,6,Ronplanet,02-03-2016,Indianapolis,IN,1,Northbrook,IL,03-03-2016,315,315,5028,5230,97,Domestic,5,2016-03-02,2016-03-03,3,2,202,1 days,2074799,1855496
1377,11378,3,2,Fixcan,02-03-2016,Madison,WI,1,Kalamazoo,MI,03-03-2016,263,263,8077,8545,78,Domestic,4,2016-03-02,2016-03-03,3,2,468,1 days,2083344,1863573
10,10011,2,7,Indi-dox,02-03-2016,Green Bay,WI,6,Joliet,IL,08-03-2016,470,284,3389,3978,55,International,2,2016-03-02,2016-03-08,3,2,589,6 days,2087322,1866962
743,10744,2,5,Lamlab,02-03-2016,Cincinnati,OH,8,Gary,IN,10-03-2016,754,350,4571,4763,92,International,10,2016-03-02,2016-03-10,3,2,192,8 days,2092085,1871533
1202,11203,2,3,Keyzunbase,02-03-2016,Appleton,WI,1,Grand Rapids,MI,03-03-2016,932,526,7977,8757,81,Intercom,10,2016-03-02,2016-03-03,3,2,780,1 days,2100842,1879510
51,10052,2,5,Fasezim,02-03-2016,Naperville,IL,2,Indianapolis,IN,03-03-2016,832,458,6187,6513,58,Domestic,1,2016-03-02,2016-03-03,3,2,326,1 days,2107355,1885697
1147,11148,2,5,Jaydox,02-03-2016,Northbrook,IL,1,Naperville,IL,03-03-2016,1160,522,5837,6816,59,Domestic,2,2016-03-02,2016-03-03,3,2,979,1 days,2114171,1891534
1764,11765,2,6,Zathlane,02-03-2016,Gary,IN,5,Milwaukee,WI,07-03-2016,689,689,126,294,82,International,7,2016-03-02,2016-03-07,3,2,168,5 days,2114465,1891660
389,10390,1,8,Zummatexon,02-03-2016,Green Bay,WI,4,Joliet,IL,06-03-2016,1022,479,6497,6819,67,Domestic,2,2016-03-02,2016-03-06,3,2,322,4 days,2121284,1898157
1098,11099,2,2,Good-find,03-03-2016,Davenport,IA,4,Appleton,WI,07-03-2016,704,468,5215,5939,96,Domestic,8,2016-03-03,2016-03-07,3,3,724,4 days,2127223,1903372
1554,11555,2,6,Vaiazozice,03-03-2016,Madison,WI,2,Kalamazoo,MI,05-03-2016,634,634,6318,6733,96,Intercom,9,2016-03-03,2016-03-05,3,3,415,2 days,2133956,1909690
818,10819,1,4,zathhow,03-03-2016,Chicago,IL,1,Rockford,IL,04-03-2016,638,638,6417,4224,81,Domestic,2,2016-03-03,2016-03-04,3,3,-2193,1 days,2138180,1916107
639,10640,1,8,Howplanet,03-03-2016,Bangor,MI,2,Davenport,IA,05-03-2016,390,390,4594,4956,54,Domestic,4,2016-03-03,2016-03-05,3,3,362,2 days,2143136,1920701
543,10544,2,8,Joyzim,03-03-2016,Appleton,WI,2,Grand Rapids,MI,05-03-2016,1162,637,96,626,69,Intercom,7,2016-03-03,2016-03-05,3,3,530,2 days,2143762,1920797
1478,11479,2,5,Goldentechi,03-03-2016,Springfield,IL,2,Skokie,IL,05-03-2016,233,203,5624,6000,95,Intercom,4,2016-03-03,2016-03-05,3,3,376,2 days,2149762,1926421
1645,11646,2,6,planetron,03-03-2016,Toledo,OH,2,Detriot,MI,05-03-2016,396,337,4932,5355,89,Domestic,5,2016-03-03,2016-03-05,3,3,423,2 days,2155117,1931353
139,10140,2,7,Ronvivalam,04-03-2016,Lansing,MI,3,Dayton,OH,07-03-2016,814,714,1649,2329,65,Domestic,6,2016-03-04,2016-03-07,3,4,680,3 days,2157446,1933002
632,10633,2,6,Bamtechnology,04-03-2016,Naperville,IL,2,Indianapolis,IN,05-03-2016,380,380,1910,2067,97,Domestic,6,2016-03-04,2016-03-05,3,4,157,1 days,2159513,1934912
1537,11538,3,3,Zaamhouse,04-03-2016,Dayton,OH,3,Elgin,IL,07-03-2016,1133,279,668,958,85,Domestic,7,2016-03-04,2016-03-07,3,4,290,3 days,2160471,1935580
1600,11601,2,2,Scotcan,04-03-2016,Dayton,OH,3,Elgin,IL,04-03-2016,1014,235,3038,3544,100,Domestic,5,2016-03-04,2016-03-04,3,4,506,0 days,2164015,1938618
1660,11661,2,3,geohigh,04-03-2016,Rockford,IL,2,Green Bay,WI,06-03-2016,1013,424,8006,8753,80,Domestic,4,2016-03-04,2016-03-06,3,4,747,2 days,2172768,1946624
151,10152,1,6,Lamlab,04-03-2016,Gary,IN,2,Milwaukee,WI,06-03-2016,636,536,7145,7537,72,Domestic,4,2016-03-04,2016-03-06,3,4,392,2 days,2180305,1953769
1708,11709,2,2,Faxzumtrax,04-03-2016,Elgin,IL,7,Cincinnati,OH,11-03-2016,360,360,3877,4031,99,International,7,2016-03-04,2016-03-11,3,4,154,7 days,2184336,1957646
762,10763,2,6,geohigh,04-03-2016,Rockford,IL,5,Green Bay,WI,21-03-2016,568,568,8309,8508,90,International,1,2016-03-04,2016-03-21,3,4,199,17 days,2192844,1965955
1409,11410,2,2,re-can,04-03-2016,Kalamazoo,MI,8,Bangor,MI,11-03-2016,721,419,2021,2498,80,International,10,2016-03-04,2016-03-11,3,4,477,7 days,2195342,1967976
1580,11581,2,5,Beta-ron,04-03-2016,Toledo,OH,3,Detriot,MI,07-03-2016,287,287,2875,3433,97,Domestic,3,2016-03-04,2016-03-07,3,4,558,3 days,2198775,1970851
856,10857,2,6,Vivazim,05-03-2016,Lansing,MI,2,Dayton,OH,07-03-2016,274,274,7657,8611,98,Intercom,3,2016-03-05,2016-03-07,3,5,954,2 days,2207386,1978508
1550,11551,2,6,Anmedia,05-03-2016,Detriot,MI,6,Monon,IN,12-03-2016,536,455,5542,6309,89,International,9,2016-03-05,2016-03-12,3,5,767,7 days,2213695,1984050
116,10117,1,6,Silverace,05-03-2016,Toledo,OH,2,Detriot,MI,07-03-2016,559,216,7038,7844,97,Domestic,1,2016-03-05,2016-03-07,3,5,806,2 days,2221539,1991088
592,10593,2,8,san-plex,05-03-2016,Toledo,OH,1,Detriot,MI,06-03-2016,828,655,779,1238,96,Domestic,7,2016-03-05,2016-03-06,3,5,459,1 days,2222777,1991867
1632,11633,3,3,Faxotfind,05-03-2016,Indianapolis,IN,4,Northbrook,IL,09-03-2016,692,692,4059,4695,63,Domestic,8,2016-03-05,2016-03-09,3,5,636,4 days,2227472,1995926
1002,11003,2,1,Xx-planet,05-03-2016,Rockford,IL,2,Green Bay,WI,07-03-2016,936,427,1396,5802,99,Domestic,2,2016-03-05,2016-03-07,3,5,4406,2 days,2233274,1997322
649,10650,1,6,Anmedia,05-03-2016,Detriot,MI,2,Monon,IN,07-03-2016,1143,563,7882,8267,61,Domestic,2,2016-03-05,2016-03-07,3,5,385,2 days,2241541,2005204
1767,11768,3,3,Viacane,05-03-2016,Green Bay,WI,1,Joliet,IL,06-03-2016,1094,354,8459,8818,52,Domestic,10,2016-03-05,2016-03-06,3,5,359,1 days,2250359,2013663
253,10254,1,8,O-tom,05-03-2016,Detriot,MI,2,Monon,IN,07-03-2016,901,530,3739,4153,54,Intercom,8,2016-03-05,2016-03-07,3,5,414,2 days,2254512,2017402
168,10169,2,4,Indibase,05-03-2016,Chicago,IL,2,Rockford,IL,07-03-2016,328,328,2583,802,71,Domestic,1,2016-03-05,2016-03-07,3,5,-1781,2 days,2255314,2019985
1785,11786,2,2,Silverfase,06-03-2016,Northbrook,IL,8,Naperville,IL,21-03-2016,862,773,5321,6295,90,International,10,2016-03-06,2016-03-21,3,6,974,15 days,2261609,2025306
101,10102,1,5,Donplanet,06-03-2016,Davenport,IA,7,Appleton,WI,10-03-2016,988,333,306,917,80,International,2,2016-03-06,2016-03-10,3,6,611,4 days,2262526,2025612
90,10091,2,7,Fin-cone,06-03-2016,Naperville,IL,4,Indianapolis,IN,09-03-2016,669,332,2235,2655,85,Domestic,5,2016-03-06,2016-03-09,3,6,420,3 days,2265181,2027847
1378,11379,3,6,Dentoelectrics,06-03-2016,Green Bay,WI,3,Joliet,IL,09-03-2016,425,425,7781,8270,88,Domestic,9,2016-03-06,2016-03-09,3,6,489,3 days,2273451,2035628
729,10730,1,6,Cityis,06-03-2016,Skokie,IL,7,Chicago,IL,21-03-2016,467,363,6208,7203,88,International,10,2016-03-06,2016-03-21,3,6,995,15 days,2280654,2041836
1382,11383,2,3,Alphadax,06-03-2016,Dayton,OH,4,Elgin,IL,08-03-2016,773,601,5120,5994,68,Domestic,9,2016-03-06,2016-03-08,3,6,874,2 days,2286648,2046956
1622,11623,2,5,Goodquoing,06-03-2016,Toledo,OH,10,Detriot,MI,21-03-2016,824,545,7805,8613,76,International,2,2016-03-06,2016-03-21,3,6,808,15 days,2295261,2054761
203,10204,2,4,Scotlex,06-03-2016,Kalamazoo,MI,5,Bangor,MI,08-03-2016,1107,730,2776,1197,76,International,8,2016-03-06,2016-03-08,3,6,-1579,2 days,2296458,2057537
483,10484,1,4,Alphadax,07-03-2016,Dayton,OH,1,Elgin,IL,08-03-2016,349,349,6634,4927,65,Domestic,5,2016-03-07,2016-03-08,3,7,-1707,1 days,2301385,2064171
838,10839,1,6,Konknix,07-03-2016,Grand Rapids,MI,3,Toledo,OH,10-03-2016,219,219,485,721,86,Domestic,4,2016-03-07,2016-03-10,3,7,236,3 days,2302106,2064656
148,10149,2,4,Y-zoom,07-03-2016,Indianapolis,IN,7,Northbrook,IL,14-03-2016,393,379,1926,142,52,International,3,2016-03-07,2016-03-14,3,7,-1784,7 days,2302248,2066582
552,10553,1,7,villahouse,07-03-2016,Grand Rapids,MI,2,Toledo,OH,09-03-2016,1179,658,1843,2235,50,Domestic,8,2016-03-07,2016-03-09,3,7,392,2 days,2304483,2068425
485,10486,2,5,Alphafan,07-03-2016,Lansing,MI,4,Dayton,OH,11-03-2016,273,273,3302,3490,71,Domestic,8,2016-03-07,2016-03-11,3,7,188,4 days,2307973,2071727
386,10387,1,6,roundphase,07-03-2016,Joliet,IL,2,Madison,WI,08-03-2016,618,204,7216,7893,61,Domestic,6,2016-03-07,2016-03-08,3,7,677,1 days,2315866,2078943
1231,11232,3,3,dripkix,07-03-2016,Skokie,IL,1,Chicago,IL,08-03-2016,711,242,2893,3318,85,Domestic,5,2016-03-07,2016-03-08,3,7,425,1 days,2319184,2081836
823,10824,2,7,Namelectronics,07-03-2016,Monon,IN,2,Lansing,MI,09-03-2016,568,509,2010,2921,63,Domestic,5,2016-03-07,2016-03-09,3,7,911,2 days,2322105,2083846
1306,11307,2,5,Jaylane,07-03-2016,Joliet,IL,2,Madison,WI,08-03-2016,277,277,1929,2654,76,Domestic,5,2016-03-07,2016-03-08,3,7,725,1 days,2324759,2085775
1062,11063,2,4,Goldenlex,07-03-2016,Gary,IN,1,Milwaukee,WI,08-03-2016,938,260,3202,404,93,Domestic,6,2016-03-07,2016-03-08,3,7,-2798,1 days,2325163,2088977
217,10218,2,8,Faxzumtrax,07-03-2016,Naperville,IL,9,Indianapolis,IN,16-03-2016,411,411,3865,4172,79,International,9,2016-03-07,2016-03-16,3,7,307,9 days,2329335,2092842
912,10913,3,1,Baselux,08-03-2016,Northbrook,IL,10,Naperville,IL,21-03-2016,1109,505,5198,10155,90,International,1,2016-03-08,2016-03-21,3,8,4957,13 days,2339490,2098040
1534,11535,2,3,dripkix,08-03-2016,Rockford,IL,5,Green Bay,WI,21-03-2016,411,411,8227,8949,70,International,10,2016-03-08,2016-03-21,3,8,722,13 days,2348439,2106267
1171,11172,2,2,tinron,08-03-2016,Northbrook,IL,3,Naperville,IL,11-03-2016,810,633,214,441,63,Domestic,10,2016-03-08,2016-03-11,3,8,227,3 days,2348880,2106481
617,10618,2,5,Cannamcon,08-03-2016,Elgin,IL,8,Cincinnati,OH,16-03-2016,529,450,6014,6538,53,International,8,2016-03-08,2016-03-16,3,8,524,8 days,2355418,2112495
669,10670,2,4,Vaiazoom,08-03-2016,Chicago,IL,4,Rockford,IL,12-03-2016,388,388,6071,3903,82,Domestic,2,2016-03-08,2016-03-12,3,8,-2168,4 days,2359321,2118566
201,10202,1,6,Dingcan,09-03-2016,Bangor,MI,3,Davenport,IA,12-03-2016,802,703,2842,3827,55,Domestic,2,2016-03-09,2016-03-12,3,9,985,3 days,2363148,2121408
143,10144,2,4,Hexunobam,09-03-2016,Kalamazoo,MI,3,Bangor,MI,12-03-2016,732,201,7807,5690,54,Domestic,10,2016-03-09,2016-03-12,3,9,-2117,3 days,2368838,2129215
570,10571,2,8,Zamlane,09-03-2016,Lansing,MI,2,Dayton,OH,11-03-2016,429,325,1876,2259,86,Domestic,8,2016-03-09,2016-03-11,3,9,383,2 days,2371097,2131091
37,10038,2,5,Xx-dotone,09-03-2016,Elgin,IL,3,Cincinnati,OH,12-03-2016,1047,398,6309,6723,88,Domestic,9,2016-03-09,2016-03-12,3,9,414,3 days,2377820,2137400
960,10961,2,2,mathtouch,10-03-2016,Rockford,IL,6,Green Bay,WI,16-03-2016,401,401,7172,7857,68,International,6,2016-03-10,2016-03-16,3,10,685,6 days,2385677,2144572
1805,11806,3,4,Lazap,10-03-2016,Indianapolis,IN,3,Northbrook,IL,13-03-2016,988,352,7584,5055,64,Domestic,10,2016-03-10,2016-03-13,3,10,-2529,3 days,2390732,2152156
546,10547,2,7,Condexon,10-03-2016,Toledo,OH,4,Detriot,MI,14-03-2016,1039,547,4004,4613,61,Domestic,4,2016-03-10,2016-03-14,3,10,609,4 days,2395345,2156160
662,10663,2,7,Newzap,10-03-2016,Elgin,IL,2,Cincinnati,OH,10-03-2016,1197,234,6019,6190,58,Domestic,2,2016-03-10,2016-03-10,3,10,171,0 days,2401535,2162179
711,10712,1,8,Silverace,10-03-2016,Milwaukee,WI,7,Springfield,IL,21-03-2016,1018,484,6039,6526,73,International,3,2016-03-10,2016-03-21,3,10,487,11 days,2408061,2168218
301,10302,1,5,Recode,11-03-2016,Green Bay,WI,1,Joliet,IL,12-03-2016,614,204,4790,5610,89,Domestic,10,2016-03-11,2016-03-12,3,11,820,1 days,2413671,2173008
387,10388,1,7,Medialax,11-03-2016,Monon,IN,4,Lansing,MI,15-03-2016,303,303,4784,5203,80,Domestic,9,2016-03-11,2016-03-15,3,11,419,4 days,2418874,2177792
131,10132,1,4,Goodquoing,11-03-2016,Monon,IN,7,Lansing,MI,21-03-2016,697,495,2594,885,56,International,4,2016-03-11,2016-03-21,3,11,-1709,10 days,2419759,2180386
1150,11151,2,1,villahouse,11-03-2016,Joliet,IL,3,Madison,WI,12-03-2016,1074,553,2018,5684,77,Domestic,3,2016-03-11,2016-03-12,3,11,3666,1 days,2425443,2182404
623,10624,2,6,Whitefan,11-03-2016,Springfield,IL,9,Skokie,IL,17-03-2016,682,636,1197,1523,63,International,8,2016-03-11,2016-03-17,3,11,326,6 days,2426966,2183601
430,10431,1,7,Kantone,11-03-2016,Detriot,MI,2,Monon,IN,13-03-2016,906,319,1581,2182,69,Domestic,8,2016-03-11,2016-03-13,3,11,601,2 days,2429148,2185182
75,10076,1,7,Vaiataxon,11-03-2016,Elgin,IL,5,Cincinnati,OH,16-03-2016,443,443,3836,4534,92,International,4,2016-03-11,2016-03-16,3,11,698,5 days,2433682,2189018
86,10087,1,7,Funlax,11-03-2016,Joliet,IL,2,Madison,WI,13-03-2016,965,659,8235,8684,54,Domestic,7,2016-03-11,2016-03-13,3,11,449,2 days,2442366,2197253
858,10859,2,6,Ittam,11-03-2016,Elgin,IL,1,Cincinnati,OH,12-03-2016,225,225,6466,7168,57,Domestic,1,2016-03-11,2016-03-12,3,11,702,1 days,2449534,2203719
1456,11457,3,4,Vivazim,12-03-2016,Springfield,IL,9,Skokie,IL,21-03-2016,769,448,6266,4926,99,International,10,2016-03-12,2016-03-21,3,12,-1340,9 days,2454460,2209985
424,10425,2,7,Goodtechno,12-03-2016,Davenport,IA,10,Appleton,WI,21-03-2016,1140,710,4002,4367,86,International,1,2016-03-12,2016-03-21,3,12,365,9 days,2458827,2213987
1477,11478,3,5,Tantechi,12-03-2016,Milwaukee,WI,9,Springfield,IL,21-03-2016,481,481,1689,2348,76,International,6,2016-03-12,2016-03-21,3,12,659,9 days,2461175,2215676
22,10023,2,8,scotquote,12-03-2016,Springfield,IL,2,Skokie,IL,14-03-2016,680,303,1417,1663,85,Domestic,7,2016-03-12,2016-03-14,3,12,246,2 days,2462838,2217093
1203,11204,3,5,K-is,12-03-2016,Cincinnati,OH,3,Gary,IN,15-03-2016,430,430,7975,8312,78,Domestic,4,2016-03-12,2016-03-15,3,12,337,3 days,2471150,2225068
144,10145,1,7,Opehouse,13-03-2016,Grand Rapids,MI,2,Toledo,OH,13-03-2016,587,587,3197,3471,90,Domestic,6,2016-03-13,2016-03-13,3,13,274,0 days,2474621,2228265
1648,11649,3,5,Lexidom,13-03-2016,Kalamazoo,MI,1,Bangor,MI,14-03-2016,536,536,3143,3855,98,Domestic,4,2016-03-13,2016-03-14,3,13,712,1 days,2478476,2231408
171,10172,2,8,Goldenlex,13-03-2016,Gary,IN,5,Milwaukee,WI,15-03-2016,1152,268,5802,6065,71,International,2,2016-03-13,2016-03-15,3,13,263,2 days,2484541,2237210
348,10349,2,5,Daltfax,13-03-2016,Cincinnati,OH,9,Gary,IN,19-03-2016,1076,699,377,546,90,International,3,2016-03-13,2016-03-19,3,13,169,6 days,2485087,2237587
238,10239,1,4,Plustaxon,13-03-2016,Rockford,IL,2,Green Bay,WI,15-03-2016,239,239,7178,5528,98,Domestic,9,2016-03-13,2016-03-15,3,13,-1650,2 days,2490615,2244765
693,10694,1,5,Plextechi,13-03-2016,Detriot,MI,2,Monon,IN,15-03-2016,524,524,6846,7562,74,Intercom,2,2016-03-13,2016-03-15,3,13,716,2 days,2498177,2251611
876,10877,1,2,Linetone,13-03-2016,Dayton,OH,1,Elgin,IL,14-03-2016,1186,606,5584,6366,60,Domestic,7,2016-03-13,2016-03-14,3,13,782,1 days,2504543,2257195
666,10667,1,4,J-lax,13-03-2016,Grand Rapids,MI,3,Toledo,OH,16-03-2016,999,574,1568,51,54,Domestic,1,2016-03-13,2016-03-16,3,13,-1517,3 days,2504594,2258763
866,10867,1,5,zen-holdings,14-03-2016,Northbrook,IL,2,Naperville,IL,16-03-2016,288,288,50,218,88,Domestic,2,2016-03-14,2016-03-16,3,14,168,2 days,2504812,2258813
525,10526,2,6,Icedox,14-03-2016,Dayton,OH,10,Elgin,IL,24-03-2016,940,288,598,915,64,International,10,2016-03-14,2016-03-24,3,14,317,10 days,2505727,2259411
726,10727,1,8,Fasetech,15-03-2016,Lansing,MI,10,Dayton,OH,25-03-2016,968,630,5889,6087,66,International,8,2016-03-15,2016-03-25,3,15,198,10 days,2511814,2265300
550,10551,2,8,O-tom,15-03-2016,Kalamazoo,MI,3,Bangor,MI,18-03-2016,525,525,6716,7394,82,Domestic,4,2016-03-15,2016-03-18,3,15,678,3 days,2519208,2272016
989,10990,2,2,Strongtechnology,15-03-2016,Skokie,IL,4,Chicago,IL,19-03-2016,514,514,5208,5612,50,Domestic,10,2016-03-15,2016-03-19,3,15,404,4 days,2524820,2277224
208,10209,1,8,Scothouse,15-03-2016,Chicago,IL,1,Rockford,IL,16-03-2016,843,275,605,1133,78,Domestic,1,2016-03-15,2016-03-16,3,15,528,1 days,2525953,2277829
1697,11698,3,2,Latgotrax,15-03-2016,Monon,IN,1,Lansing,MI,16-03-2016,1072,692,1484,1915,83,Domestic,8,2016-03-15,2016-03-16,3,15,431,1 days,2527868,2279313
1351,11352,2,6,Saokeycane,15-03-2016,Joliet,IL,1,Madison,WI,16-03-2016,1077,454,6067,6192,60,Domestic,2,2016-03-15,2016-03-16,3,15,125,1 days,2534060,2285380
1544,11545,2,2,Tamholding,15-03-2016,Davenport,IA,1,Appleton,WI,16-03-2016,573,573,2363,2807,66,Domestic,1,2016-03-15,2016-03-16,3,15,444,1 days,2536867,2287743
245,10246,2,8,Joyzim,15-03-2016,Kalamazoo,MI,4,Bangor,MI,19-03-2016,948,437,8264,8844,75,Domestic,1,2016-03-15,2016-03-19,3,15,580,4 days,2545711,2296007
1559,11560,2,6,Faseway,15-03-2016,Dayton,OH,4,Elgin,IL,17-03-2016,316,316,7824,8066,63,Domestic,10,2016-03-15,2016-03-17,3,15,242,2 days,2553777,2303831
786,10787,2,7,Anzammedia,16-03-2016,Appleton,WI,7,Grand Rapids,MI,22-03-2016,833,620,7683,8104,69,International,1,2016-03-16,2016-03-22,3,16,421,6 days,2561881,2311514
800,10801,2,8,Scotlex,16-03-2016,Detriot,MI,1,Monon,IN,17-03-2016,304,304,7021,7945,60,Intercom,1,2016-03-16,2016-03-17,3,16,924,1 days,2569826,2318535
1753,11754,3,5,Ittam,16-03-2016,Elgin,IL,2,Cincinnati,OH,17-03-2016,479,238,742,1135,54,Domestic,8,2016-03-16,2016-03-17,3,16,393,1 days,2570961,2319277
325,10326,1,7,Sanin,16-03-2016,Appleton,WI,1,Grand Rapids,MI,17-03-2016,495,243,5565,6560,91,Intercom,9,2016-03-16,2016-03-17,3,16,995,1 days,2577521,2324842
1440,11441,3,6,Howelectrics,16-03-2016,Madison,WI,2,Kalamazoo,MI,18-03-2016,943,594,1651,1838,82,Intercom,4,2016-03-16,2016-03-18,3,16,187,2 days,2579359,2326493
603,10604,2,5,hottaxon,16-03-2016,Northbrook,IL,4,Naperville,IL,20-03-2016,1001,788,4248,4697,78,Domestic,7,2016-03-16,2016-03-20,3,16,449,4 days,2584056,2330741
877,10878,1,2,Tantechi,16-03-2016,Toledo,OH,3,Detriot,MI,19-03-2016,759,759,322,765,53,Domestic,8,2016-03-16,2016-03-19,3,16,443,3 days,2584821,2331063
1414,11415,2,1,Sonzamace,16-03-2016,Northbrook,IL,1,Naperville,IL,17-03-2016,221,221,8182,12995,96,Domestic,5,2016-03-16,2016-03-17,3,16,4813,1 days,2597816,2339245
557,10558,2,5,saltlab,16-03-2016,Northbrook,IL,10,Naperville,IL,26-03-2016,1145,236,2158,2699,77,International,9,2016-03-16,2016-03-26,3,16,541,10 days,2600515,2341403
750,10751,1,5,Saokeycane,17-03-2016,Grand Rapids,MI,4,Toledo,OH,19-03-2016,1076,798,3560,3913,57,Domestic,5,2016-03-17,2016-03-19,3,17,353,2 days,2604428,2344963
982,10983,3,2,Trueplus,17-03-2016,Appleton,WI,1,Grand Rapids,MI,18-03-2016,785,499,439,1240,80,Intercom,10,2016-03-17,2016-03-18,3,17,801,1 days,2605668,2345402
710,10711,2,6,Jaylane,17-03-2016,Grand Rapids,MI,9,Toledo,OH,26-03-2016,633,220,2771,3293,71,International,9,2016-03-17,2016-03-26,3,17,522,9 days,2608961,2348173
1262,11263,2,6,geofind,17-03-2016,Monon,IN,4,Lansing,MI,21-03-2016,248,248,3089,3972,64,Domestic,4,2016-03-17,2016-03-21,3,17,883,4 days,2612933,2351262
11,10012,2,8,Subdrill,17-03-2016,Rockford,IL,10,Green Bay,WI,21-03-2016,1175,361,763,1477,50,International,10,2016-03-17,2016-03-21,3,17,714,4 days,2614410,2352025
509,10510,1,4,re-can,17-03-2016,Kalamazoo,MI,1,Bangor,MI,18-03-2016,758,392,1971,291,99,Intercom,2,2016-03-17,2016-03-18,3,17,-1680,1 days,2614701,2353996
108,10109,2,8,Scotcan,18-03-2016,Joliet,IL,3,Madison,WI,19-03-2016,587,367,521,910,83,Domestic,2,2016-03-18,2016-03-19,3,18,389,1 days,2615611,2354517
1044,11045,2,3,Zuntone,18-03-2016,Green Bay,WI,2,Joliet,IL,20-03-2016,1109,260,5431,6169,58,Domestic,8,2016-03-18,2016-03-20,3,18,738,2 days,2621780,2359948
1654,11655,2,5,tres-tone,18-03-2016,Northbrook,IL,10,Naperville,IL,28-03-2016,660,660,3577,4430,78,International,7,2016-03-18,2016-03-28,3,18,853,10 days,2626210,2363525
160,10161,2,6,Inzone,18-03-2016,Lansing,MI,2,Dayton,OH,20-03-2016,1029,475,6911,7281,67,Domestic,4,2016-03-18,2016-03-20,3,18,370,2 days,2633491,2370436
1736,11737,2,2,Dingfax,18-03-2016,Chicago,IL,3,Rockford,IL,21-03-2016,1162,320,2468,2835,92,Domestic,6,2016-03-18,2016-03-21,3,18,367,3 days,2636326,2372904
901,10902,2,1,tampquote,18-03-2016,Lansing,MI,4,Dayton,OH,22-03-2016,515,267,442,4379,83,Domestic,1,2016-03-18,2016-03-22,3,18,3937,4 days,2640705,2373346
1008,11009,3,6,Ronplanet,18-03-2016,Elgin,IL,4,Cincinnati,OH,22-03-2016,1079,452,7914,8741,98,Domestic,2,2016-03-18,2016-03-22,3,18,827,4 days,2649446,2381260
441,10442,2,8,Ozeris,18-03-2016,Lansing,MI,9,Dayton,OH,25-03-2016,265,265,803,978,51,International,9,2016-03-18,2016-03-25,3,18,175,7 days,2650424,2382063
1207,11208,3,4,Stimmedia,18-03-2016,Bangor,MI,9,Davenport,IA,26-03-2016,876,547,5912,3702,57,International,3,2016-03-18,2016-03-26,3,18,-2210,8 days,2654126,2387975
859,10860,1,4,saltlab,18-03-2016,Skokie,IL,2,Chicago,IL,20-03-2016,1041,202,7832,5575,94,Domestic,2,2016-03-18,2016-03-20,3,18,-2257,2 days,2659701,2395807
117,10118,2,6,Conelane,19-03-2016,Lansing,MI,8,Dayton,OH,26-03-2016,284,284,2208,3010,60,International,5,2016-03-19,2016-03-26,3,19,802,7 days,2662711,2398015
259,10260,2,4,saltlab,19-03-2016,Rockford,IL,4,Green Bay,WI,23-03-2016,1132,616,2991,911,100,Domestic,4,2016-03-19,2016-03-23,3,19,-2080,4 days,2663622,2401006
1466,11467,2,2,zen-holdings,19-03-2016,Rockford,IL,1,Green Bay,WI,20-03-2016,453,248,8607,8733,94,Domestic,1,2016-03-19,2016-03-20,3,19,126,1 days,2672355,2409613
24,10025,1,8,Lazap,19-03-2016,Indianapolis,IN,4,Northbrook,IL,22-03-2016,1094,258,8546,8824,86,Domestic,5,2016-03-19,2016-03-22,3,19,278,3 days,2681179,2418159
67,10068,1,5,Faseway,19-03-2016,Joliet,IL,4,Madison,WI,21-03-2016,222,222,7465,7721,99,Domestic,6,2016-03-19,2016-03-21,3,19,256,2 days,2688900,2425624
1040,11041,2,6,Lamlab,19-03-2016,Gary,IN,5,Milwaukee,WI,22-03-2016,292,292,3753,4586,62,International,9,2016-03-19,2016-03-22,3,19,833,3 days,2693486,2429377
621,10622,1,7,Zoncone,19-03-2016,Grand Rapids,MI,3,Toledo,OH,22-03-2016,1088,202,30,821,69,Domestic,2,2016-03-19,2016-03-22,3,19,791,3 days,2694307,2429407
941,10942,2,2,Sanlab,19-03-2016,Rockford,IL,1,Green Bay,WI,20-03-2016,744,649,525,742,83,Domestic,10,2016-03-19,2016-03-20,3,19,217,1 days,2695049,2429932
529,10530,1,8,Ganzlane,20-03-2016,Elgin,IL,4,Cincinnati,OH,24-03-2016,827,565,5772,6077,56,Domestic,5,2016-03-20,2016-03-24,3,20,305,4 days,2701126,2435704
895,10896,2,2,Damdexon,20-03-2016,Naperville,IL,3,Indianapolis,IN,23-03-2016,763,655,884,1342,57,Domestic,1,2016-03-20,2016-03-23,3,20,458,3 days,2702468,2436588
1504,11505,3,5,K-is,20-03-2016,Gary,IN,4,Milwaukee,WI,24-03-2016,944,522,1657,1930,62,Domestic,3,2016-03-20,2016-03-24,3,20,273,4 days,2704398,2438245
667,10668,2,7,geofind,20-03-2016,Milwaukee,WI,3,Springfield,IL,23-03-2016,1013,492,783,1711,64,Domestic,4,2016-03-20,2016-03-23,3,20,928,3 days,2706109,2439028
518,10519,1,5,Statway,20-03-2016,Joliet,IL,3,Madison,WI,23-03-2016,537,249,1440,2166,50,Domestic,8,2016-03-20,2016-03-23,3,20,726,3 days,2708275,2440468
400,10401,1,6,Trustcorporation,21-03-2016,Kalamazoo,MI,2,Bangor,MI,23-03-2016,614,614,3550,4334,98,Intercom,1,2016-03-21,2016-03-23,3,21,784,2 days,2712609,2444018
1636,11637,3,4,Opehouse,21-03-2016,Joliet,IL,2,Madison,WI,21-03-2016,1180,369,7965,6106,62,Domestic,2,2016-03-21,2016-03-21,3,21,-1859,0 days,2718715,2451983
1733,11734,3,3,Konknix,21-03-2016,Grand Rapids,MI,4,Toledo,OH,22-03-2016,520,283,1316,1755,78,Domestic,7,2016-03-21,2016-03-22,3,21,439,1 days,2720470,2453299
1029,11030,3,4,Dingquokix,21-03-2016,Toledo,OH,1,Detriot,MI,22-03-2016,922,292,2407,40,83,Domestic,10,2016-03-21,2016-03-22,3,21,-2367,1 days,2720510,2455706
1302,11303,3,1,Solostreet,21-03-2016,Indianapolis,IN,1,Northbrook,IL,22-03-2016,1129,291,3628,8175,55,Domestic,8,2016-03-21,2016-03-22,3,21,4547,1 days,2728685,2459334
1265,11266,3,4,Vaiataxon,21-03-2016,Naperville,IL,2,Indianapolis,IN,23-03-2016,247,247,4532,2815,65,Domestic,9,2016-03-21,2016-03-23,3,21,-1717,2 days,2731500,2463866
983,10984,3,1,Templax,21-03-2016,Cincinnati,OH,3,Gary,IN,24-03-2016,582,237,6479,11083,76,Domestic,8,2016-03-21,2016-03-24,3,21,4604,3 days,2742583,2470345
1787,11788,3,1,xx-way,21-03-2016,Joliet,IL,2,Madison,WI,23-03-2016,928,757,1915,6011,54,Domestic,7,2016-03-21,2016-03-23,3,21,4096,2 days,2748594,2472260
997,10998,2,3,Scotcan,22-03-2016,Joliet,IL,6,Madison,WI,28-03-2016,594,594,4605,5545,67,International,7,2016-03-22,2016-03-28,3,22,940,6 days,2754139,2476865
247,10248,1,7,una-phase,22-03-2016,Grand Rapids,MI,4,Toledo,OH,23-03-2016,649,649,4755,5022,79,Domestic,7,2016-03-22,2016-03-23,3,22,267,1 days,2759161,2481620
1640,11641,3,2,Y-zoom,22-03-2016,Naperville,IL,10,Indianapolis,IN,01-04-2016,601,365,803,1765,50,International,4,2016-03-22,2016-04-01,3,22,962,10 days,2760926,2482423
1643,11644,2,4,Lamlab,22-03-2016,Cincinnati,OH,4,Gary,IN,26-03-2016,1082,620,4786,2738,97,Domestic,2,2016-03-22,2016-03-26,3,22,-2048,4 days,2763664,2487209
414,10415,2,6,Lexiplus,22-03-2016,Rockford,IL,10,Green Bay,WI,01-04-2016,762,334,3494,3902,73,International,7,2016-03-22,2016-04-01,3,22,408,10 days,2767566,2490703
212,10213,2,8,Unatrax,22-03-2016,Gary,IN,1,Milwaukee,WI,23-03-2016,614,430,62,638,76,Domestic,3,2016-03-22,2016-03-23,3,22,576,1 days,2768204,2490765
61,10062,1,4,Physcone,22-03-2016,Grand Rapids,MI,9,Toledo,OH,31-03-2016,563,563,5547,3321,65,International,1,2016-03-22,2016-03-31,3,22,-2226,9 days,2771525,2496312
1148,11149,2,1,O-tom,22-03-2016,Detriot,MI,5,Monon,IN,26-03-2016,290,289,1185,4621,76,International,5,2016-03-22,2016-03-26,3,22,3436,4 days,2776146,2497497
741,10742,1,5,Faxron,23-03-2016,Rockford,IL,6,Green Bay,WI,29-03-2016,863,517,2331,3290,98,International,5,2016-03-23,2016-03-29,3,23,959,6 days,2779436,2499828
760,10761,2,6,Indibase,23-03-2016,Green Bay,WI,5,Joliet,IL,28-03-2016,963,227,5991,6242,94,International,7,2016-03-23,2016-03-28,3,23,251,5 days,2785678,2505819
1618,11619,2,5,D-zohex,23-03-2016,Rockford,IL,6,Green Bay,WI,31-03-2016,508,202,5611,6081,84,International,7,2016-03-23,2016-03-31,3,23,470,8 days,2791759,2511430
638,10639,1,8,Zuntexon,23-03-2016,Lansing,MI,2,Dayton,OH,25-03-2016,392,392,4270,4540,99,Intercom,2,2016-03-23,2016-03-25,3,23,270,2 days,2796299,2515700
1429,11430,2,3,Tonsanhigh,23-03-2016,Kalamazoo,MI,2,Bangor,MI,25-03-2016,492,492,1144,1754,73,Domestic,8,2016-03-23,2016-03-25,3,23,610,2 days,2798053,2516844
758,10759,1,4,doubleis,23-03-2016,Monon,IN,9,Lansing,MI,01-04-2016,267,267,3696,1931,63,International,8,2016-03-23,2016-04-01,3,23,-1765,9 days,2799984,2520540
1287,11288,3,2,Zummatexon,24-03-2016,Green Bay,WI,1,Joliet,IL,25-03-2016,477,477,297,515,87,Domestic,8,2016-03-24,2016-03-25,3,24,218,1 days,2800499,2520837
655,10656,1,8,nimlab,24-03-2016,Naperville,IL,10,Indianapolis,IN,03-04-2016,431,431,3846,4526,78,International,1,2016-03-24,2016-04-03,3,24,680,10 days,2805025,2524683
958,10959,2,1,Scotfase,24-03-2016,Green Bay,WI,1,Joliet,IL,25-03-2016,1080,272,7801,11626,68,Domestic,7,2016-03-24,2016-03-25,3,24,3825,1 days,2816651,2532484
1577,11578,3,4,Zamholdings,24-03-2016,Rockford,IL,2,Green Bay,WI,26-03-2016,246,246,4683,2315,64,Domestic,2,2016-03-24,2016-03-26,3,24,-2368,2 days,2818966,2537167
1217,11218,2,6,Zerfax,24-03-2016,Northbrook,IL,7,Naperville,IL,31-03-2016,882,287,6118,6456,77,International,1,2016-03-24,2016-03-31,3,24,338,7 days,2825422,2543285
1646,11647,3,1,Stimcore,24-03-2016,Lansing,MI,5,Dayton,OH,27-03-2016,1143,669,7606,11703,92,International,9,2016-03-24,2016-03-27,3,24,4097,3 days,2837125,2550891
1230,11231,2,1,Bamtechnology,24-03-2016,Elgin,IL,2,Cincinnati,OH,26-03-2016,1004,598,1093,5295,80,Domestic,2,2016-03-24,2016-03-26,3,24,4202,2 days,2842420,2551984
553,10554,1,5,Tempfan,24-03-2016,Milwaukee,WI,1,Springfield,IL,25-03-2016,620,620,772,1207,68,Domestic,5,2016-03-24,2016-03-25,3,24,435,1 days,2843627,2552756
724,10725,2,6,Zunice,24-03-2016,Dayton,OH,3,Elgin,IL,24-03-2016,778,758,3071,3781,54,Domestic,10,2016-03-24,2016-03-24,3,24,710,0 days,2847408,2555827
1746,11747,3,2,Jaydox,24-03-2016,Rockford,IL,7,Green Bay,WI,21-03-2016,525,355,626,1360,86,International,7,2016-03-24,2016-03-21,3,24,734,-3 days,2848768,2556453
1357,11358,3,4,unaity,24-03-2016,Appleton,WI,4,Grand Rapids,MI,28-03-2016,1048,594,3105,904,95,Domestic,9,2016-03-24,2016-03-28,3,24,-2201,4 days,2849672,2559558
688,10689,2,4,Medialax,24-03-2016,Milwaukee,WI,10,Springfield,IL,03-04-2016,631,319,4791,2154,67,International,5,2016-03-24,2016-04-03,3,24,-2637,10 days,2851826,2564349
1441,11442,2,1,Dingfax,24-03-2016,Green Bay,WI,1,Joliet,IL,25-03-2016,697,557,1144,5076,70,Domestic,5,2016-03-24,2016-03-25,3,24,3932,1 days,2856902,2565493
1490,11491,3,2,Howtaxon,24-03-2016,Cincinnati,OH,2,Gary,IN,26-03-2016,1127,659,4666,5028,70,Domestic,8,2016-03-24,2016-03-26,3,24,362,2 days,2861930,2570159
127,10128,2,5,Tamtexon,25-03-2016,Indianapolis,IN,4,Northbrook,IL,27-03-2016,1069,362,2981,3523,83,Domestic,6,2016-03-25,2016-03-27,3,25,542,2 days,2865453,2573140
1129,11130,2,5,Jobtechnology,25-03-2016,Monon,IN,2,Lansing,MI,27-03-2016,415,349,7780,8652,76,Domestic,8,2016-03-25,2016-03-27,3,25,872,2 days,2874105,2580920
1093,11094,3,2,Fasezoomfix,25-03-2016,Lansing,MI,6,Dayton,OH,30-03-2016,300,283,1660,2220,62,International,3,2016-03-25,2016-03-30,3,25,560,5 days,2876325,2582580
834,10835,2,7,Danfan,25-03-2016,Elgin,IL,9,Cincinnati,OH,03-04-2016,721,312,2555,2685,80,International,6,2016-03-25,2016-04-03,3,25,130,9 days,2879010,2585135
446,10447,2,4,Geoit,25-03-2016,Grand Rapids,MI,2,Toledo,OH,27-03-2016,268,268,6177,3709,99,Domestic,9,2016-03-25,2016-03-27,3,25,-2468,2 days,2882719,2591312
221,10222,1,4,Zunzone,25-03-2016,Toledo,OH,4,Detriot,MI,29-03-2016,383,310,3667,1209,51,Domestic,5,2016-03-25,2016-03-29,3,25,-2458,4 days,2883928,2594979
1538,11539,2,3,zoofan,25-03-2016,Toledo,OH,4,Detriot,MI,29-03-2016,1067,787,3767,4281,91,Domestic,2,2016-03-25,2016-03-29,3,25,514,4 days,2888209,2598746
162,10163,1,6,Fixace,25-03-2016,Elgin,IL,4,Cincinnati,OH,26-03-2016,313,313,3579,4181,60,Domestic,7,2016-03-25,2016-03-26,3,25,602,1 days,2892390,2602325
1007,11008,2,3,Matsanice,25-03-2016,Bangor,MI,3,Davenport,IA,28-03-2016,367,367,5088,5923,93,Domestic,3,2016-03-25,2016-03-28,3,25,835,3 days,2898313,2607413
74,10075,1,7,Vaiazoom,25-03-2016,Bangor,MI,7,Davenport,IA,01-04-2016,400,400,6941,7103,74,International,2,2016-03-25,2016-04-01,3,25,162,7 days,2905416,2614354
600,10601,2,7,tampquote,25-03-2016,Springfield,IL,2,Skokie,IL,27-03-2016,210,210,7290,7603,95,Intercom,2,2016-03-25,2016-03-27,3,25,313,2 days,2913019,2621644
281,10282,2,8,Funfintech,26-03-2016,Appleton,WI,1,Grand Rapids,MI,27-03-2016,747,664,2821,3786,59,Domestic,4,2016-03-26,2016-03-27,3,26,965,1 days,2916805,2624465
813,10814,2,8,Sonzamace,26-03-2016,Skokie,IL,5,Chicago,IL,31-03-2016,857,500,6884,7307,91,International,8,2016-03-26,2016-03-31,3,26,423,5 days,2924112,2631349
204,10205,1,6,Good-find,26-03-2016,Davenport,IA,10,Appleton,WI,02-04-2016,337,337,7473,8089,62,International,9,2016-03-26,2016-04-02,3,26,616,7 days,2932201,2638822
1586,11587,2,1,Templax,26-03-2016,Davenport,IA,7,Appleton,WI,03-04-2016,698,614,5821,11534,99,International,8,2016-03-26,2016-04-03,3,26,5713,8 days,2943735,2644643
132,10133,1,4,Flexplex,26-03-2016,Green Bay,WI,3,Joliet,IL,29-03-2016,1007,357,4135,2809,81,Domestic,10,2016-03-26,2016-03-29,3,26,-1326,3 days,2946544,2648778
927,10928,3,2,Xx-dotone,26-03-2016,Elgin,IL,4,Cincinnati,OH,28-03-2016,270,270,5049,5607,93,Domestic,10,2016-03-26,2016-03-28,3,26,558,2 days,2952151,2653827
977,10978,3,5,Beta-ron,26-03-2016,Monon,IN,6,Lansing,MI,01-04-2016,233,233,8039,8578,66,International,8,2016-03-26,2016-04-01,3,26,539,6 days,2960729,2661866
1318,11319,2,2,Tamtexon,26-03-2016,Elgin,IL,2,Cincinnati,OH,27-03-2016,229,229,2505,2705,89,Domestic,5,2016-03-26,2016-03-27,3,26,200,1 days,2963434,2664371
1755,11756,3,3,Conehotice,27-03-2016,Kalamazoo,MI,2,Bangor,MI,29-03-2016,633,541,246,625,84,Domestic,10,2016-03-27,2016-03-29,3,27,379,2 days,2964059,2664617
1383,11384,3,5,Citytone,27-03-2016,Toledo,OH,5,Detriot,MI,01-04-2016,341,341,826,1264,63,International,3,2016-03-27,2016-04-01,3,27,438,5 days,2965323,2665443
137,10138,1,4,stripzim,27-03-2016,Dayton,OH,3,Elgin,IL,29-03-2016,230,230,8556,6617,94,Domestic,8,2016-03-27,2016-03-29,3,27,-1939,2 days,2971940,2673999
416,10417,2,6,Quotefix,27-03-2016,Cincinnati,OH,8,Gary,IN,04-04-2016,434,206,3131,3682,97,International,6,2016-03-27,2016-04-04,3,27,551,8 days,2975622,2677130
526,10527,2,8,Namelectronics,27-03-2016,Toledo,OH,10,Detriot,MI,21-03-2016,745,642,5058,5433,94,International,3,2016-03-27,2016-03-21,3,27,375,-6 days,2981055,2682188
1711,11712,3,1,O-ace,27-03-2016,Davenport,IA,1,Appleton,WI,28-03-2016,599,439,2861,7068,59,Domestic,6,2016-03-27,2016-03-28,3,27,4207,1 days,2988123,2685049
48,10049,2,6,Zaamhouse,27-03-2016,Joliet,IL,1,Madison,WI,28-03-2016,1007,288,2352,3042,80,Domestic,2,2016-03-27,2016-03-28,3,27,690,1 days,2991165,2687401
73,10074,2,6,Iceelectrics,27-03-2016,Lansing,MI,9,Dayton,OH,05-04-2016,248,248,17,133,62,International,6,2016-03-27,2016-04-05,3,27,116,9 days,2991298,2687418
1032,11033,2,3,Faxotfind,27-03-2016,Elgin,IL,3,Cincinnati,OH,27-03-2016,247,247,8059,8659,54,Domestic,4,2016-03-27,2016-03-27,3,27,600,0 days,2999957,2695477
222,10223,1,5,hat-core,27-03-2016,Lansing,MI,10,Dayton,OH,05-04-2016,338,338,2821,3750,73,International,8,2016-03-27,2016-04-05,3,27,929,9 days,3003707,2698298
1604,11605,3,1,Xx-planet,28-03-2016,Skokie,IL,9,Chicago,IL,21-03-2016,969,216,1166,5514,83,International,3,2016-03-28,2016-03-21,3,28,4348,-7 days,3009221,2699464
436,10437,2,4,Faxotfind,28-03-2016,Naperville,IL,9,Indianapolis,IN,06-04-2016,280,280,5911,3286,69,International,7,2016-03-28,2016-04-06,3,28,-2625,9 days,3012507,2705375
322,10323,2,6,Strongdax,28-03-2016,Green Bay,WI,6,Joliet,IL,03-04-2016,496,496,773,1542,72,International,10,2016-03-28,2016-04-03,3,28,769,6 days,3014049,2706148
719,10720,1,5,Solohex,28-03-2016,Madison,WI,1,Kalamazoo,MI,29-03-2016,679,522,2217,3032,90,Domestic,8,2016-03-28,2016-03-29,3,28,815,1 days,3017081,2708365
1712,11713,3,4,Statway,28-03-2016,Grand Rapids,MI,3,Toledo,OH,31-03-2016,1174,708,2759,1477,55,Domestic,8,2016-03-28,2016-03-31,3,28,-1282,3 days,3018558,2711124
873,10874,1,5,Gogokeying,28-03-2016,Naperville,IL,8,Indianapolis,IN,05-04-2016,213,213,2144,2835,69,International,5,2016-03-28,2016-04-05,3,28,691,8 days,3021393,2713268
440,10441,1,6,Opehouse,29-03-2016,Dayton,OH,4,Elgin,IL,02-04-2016,791,531,2514,3105,83,Domestic,2,2016-03-29,2016-04-02,3,29,591,4 days,3024498,2715782
427,10428,1,5,Flexplex,29-03-2016,Chicago,IL,3,Rockford,IL,01-04-2016,635,426,7381,8067,97,Domestic,4,2016-03-29,2016-04-01,3,29,686,3 days,3032565,2723163
1557,11558,3,1,Blueit,29-03-2016,Appleton,WI,9,Grand Rapids,MI,06-04-2016,749,432,1464,6719,57,International,7,2016-03-29,2016-04-06,3,29,5255,8 days,3039284,2724627
180,10181,1,7,Dentoelectrics,29-03-2016,Bangor,MI,7,Davenport,IA,05-04-2016,211,211,6122,7098,53,International,2,2016-03-29,2016-04-05,3,29,976,7 days,3046382,2730749
344,10345,2,6,Unoex,29-03-2016,Green Bay,WI,1,Joliet,IL,30-03-2016,293,293,3826,4316,92,Domestic,1,2016-03-29,2016-03-30,3,29,490,1 days,3050698,2734575
1771,11772,3,6,Donware,29-03-2016,Cincinnati,OH,10,Gary,IN,05-04-2016,613,613,3613,3822,70,International,6,2016-03-29,2016-04-05,3,29,209,7 days,3054520,2738188
841,10842,1,4,Dingfax,29-03-2016,Chicago,IL,8,Rockford,IL,05-04-2016,716,445,8317,6058,64,International,2,2016-03-29,2016-04-05,3,29,-2259,7 days,3060578,2746505
330,10331,1,8,Yearlex,29-03-2016,Bangor,MI,9,Davenport,IA,04-04-2016,661,514,272,866,66,International,6,2016-03-29,2016-04-04,3,29,594,6 days,3061444,2746777
369,10370,1,5,Singleholdings,30-03-2016,Cincinnati,OH,4,Gary,IN,03-04-2016,557,501,1623,2421,74,Domestic,3,2016-03-30,2016-04-03,3,30,798,4 days,3063865,2748400
1454,11455,2,3,villahouse,30-03-2016,Grand Rapids,MI,2,Toledo,OH,30-03-2016,741,366,5408,6167,71,Domestic,10,2016-03-30,2016-03-30,3,30,759,0 days,3070032,2753808
140,10141,2,8,Y-flex,30-03-2016,Bangor,MI,3,Davenport,IA,02-04-2016,972,211,5245,5681,68,Domestic,10,2016-03-30,2016-04-02,3,30,436,3 days,3075713,2759053
68,10069,1,6,Tripplekix,30-03-2016,Monon,IN,2,Lansing,MI,01-04-2016,815,627,982,1798,99,Domestic,1,2016-03-30,2016-04-01,3,30,816,2 days,3077511,2760035
827,10828,1,8,Streetlam,30-03-2016,Rockford,IL,2,Green Bay,WI,01-04-2016,1022,447,1665,2265,95,Domestic,5,2016-03-30,2016-04-01,3,30,600,2 days,3079776,2761700
1099,11100,2,2,Plexlamway,30-03-2016,Grand Rapids,MI,4,Toledo,OH,03-04-2016,849,408,4588,4689,89,Domestic,5,2016-03-30,2016-04-03,3,30,101,4 days,3084465,2766288
973,10974,2,4,Zamholdings,30-03-2016,Northbrook,IL,2,Naperville,IL,01-04-2016,1090,370,5981,4160,73,Domestic,1,2016-03-30,2016-04-01,3,30,-1821,2 days,3088625,2772269
287,10288,1,4,Viatom,31-03-2016,Elgin,IL,6,Cincinnati,OH,06-04-2016,381,381,5904,3890,74,International,9,2016-03-31,2016-04-06,3,31,-2014,6 days,3092515,2778173
267,10268,1,4,zen-holdings,31-03-2016,Skokie,IL,5,Chicago,IL,05-04-2016,363,363,4423,2640,97,International,4,2016-03-31,2016-04-05,3,31,-1783,5 days,3095155,2782596
917,10918,2,2,Overtam,31-03-2016,Madison,WI,8,Kalamazoo,MI,05-04-2016,1149,435,1849,2574,95,International,1,2016-03-31,2016-04-05,3,31,725,5 days,3097729,2784445
747,10748,2,6,techmedia,31-03-2016,Elgin,IL,2,Cincinnati,OH,02-04-2016,586,413,4263,4601,100,Domestic,4,2016-03-31,2016-04-02,3,31,338,2 days,3102330,2788708
1458,11459,3,6,Ittam,31-03-2016,Indianapolis,IN,10,Northbrook,IL,10-04-2016,971,275,993,1451,51,International,5,2016-03-31,2016-04-10,3,31,458,10 days,3103781,2789701
1396,11397,2,1,white-high,01-04-2016,Monon,IN,1,Lansing,MI,02-04-2016,469,469,2123,6608,73,Domestic,6,2016-04-01,2016-04-02,4,1,4485,1 days,3110389,2791824
691,10692,2,4,Aptaxon,01-04-2016,Indianapolis,IN,9,Northbrook,IL,10-04-2016,1090,278,3505,1098,92,International,9,2016-04-01,2016-04-10,4,1,-2407,9 days,3111487,2795329
154,10155,1,5,Zuntone,01-04-2016,Green Bay,WI,7,Joliet,IL,06-04-2016,329,329,4455,5455,90,International,2,2016-04-01,2016-04-06,4,1,1000,5 days,3116942,2799784
1415,11416,3,2,Linezatlam,01-04-2016,Detriot,MI,2,Monon,IN,03-04-2016,259,231,5011,5952,93,Domestic,1,2016-04-01,2016-04-03,4,1,941,2 days,3122894,2804795
777,10778,1,7,conestreet,01-04-2016,Indianapolis,IN,2,Northbrook,IL,02-04-2016,436,354,2756,3403,71,Domestic,2,2016-04-01,2016-04-02,4,1,647,1 days,3126297,2807551
1205,11206,2,2,zotit,01-04-2016,Toledo,OH,2,Detriot,MI,03-04-2016,812,402,5748,6366,70,Domestic,6,2016-04-01,2016-04-03,4,1,618,2 days,3132663,2813299
1491,11492,2,3,xx-way,01-04-2016,Dayton,OH,2,Elgin,IL,02-04-2016,939,446,6371,7224,93,Domestic,6,2016-04-01,2016-04-02,4,1,853,1 days,3139887,2819670
886,10887,1,1,bamity,01-04-2016,Springfield,IL,3,Skokie,IL,04-04-2016,565,205,852,5815,98,Domestic,7,2016-04-01,2016-04-04,4,1,4963,3 days,3145702,2820522
332,10333,1,7,xx-bam,01-04-2016,Davenport,IA,2,Appleton,WI,03-04-2016,884,631,1394,2083,74,Domestic,3,2016-04-01,2016-04-03,4,1,689,2 days,3147785,2821916
868,10869,2,5,Zathlane,01-04-2016,Gary,IN,2,Milwaukee,WI,03-04-2016,1166,321,4576,4752,82,Domestic,1,2016-04-01,2016-04-03,4,1,176,2 days,3152537,2826492
460,10461,2,6,Scotline,01-04-2016,Cincinnati,OH,10,Gary,IN,08-04-2016,246,246,1043,1897,78,International,2,2016-04-01,2016-04-08,4,1,854,7 days,3154434,2827535
1323,11324,2,3,Fasetech,01-04-2016,Springfield,IL,4,Skokie,IL,05-04-2016,297,297,338,1250,89,Domestic,5,2016-04-01,2016-04-05,4,1,912,4 days,3155684,2827873
458,10459,1,6,tres-tone,01-04-2016,Rockford,IL,1,Green Bay,WI,02-04-2016,477,234,6954,7115,87,Domestic,8,2016-04-01,2016-04-02,4,1,161,1 days,3162799,2834827
1210,11211,2,6,Dingity,02-04-2016,Kalamazoo,MI,2,Bangor,MI,04-04-2016,342,342,2783,3720,100,Domestic,8,2016-04-02,2016-04-04,4,2,937,2 days,3166519,2837610
1789,11790,2,1,Dentocity,02-04-2016,Madison,WI,5,Kalamazoo,MI,05-04-2016,638,638,2496,7123,50,International,1,2016-04-02,2016-04-05,4,2,4627,3 days,3173642,2840106
998,10999,3,3,Duoflex,02-04-2016,Monon,IN,10,Lansing,MI,21-03-2016,386,386,7916,8284,50,International,6,2016-04-02,2016-03-21,4,2,368,-12 days,3181926,2848022
1647,11648,3,1,Zuntone,02-04-2016,Bangor,MI,10,Davenport,IA,09-04-2016,497,216,7995,11529,63,International,9,2016-04-02,2016-04-09,4,2,3534,7 days,3193455,2856017
1282,11283,3,5,Trueplus,02-04-2016,Detriot,MI,1,Monon,IN,03-04-2016,790,584,823,1445,71,Domestic,7,2016-04-02,2016-04-03,4,2,622,1 days,3194900,2856840
42,10043,2,4,Saohow,02-04-2016,Springfield,IL,7,Skokie,IL,09-04-2016,1187,742,6043,4255,52,International,2,2016-04-02,2016-04-09,4,2,-1788,7 days,3199155,2862883
1658,11659,2,1,doubleis,03-04-2016,Monon,IN,6,Lansing,MI,21-03-2016,320,320,4053,8405,90,International,5,2016-04-03,2016-03-21,4,3,4352,-13 days,3207560,2866936
541,10542,1,8,Howelectrics,03-04-2016,Madison,WI,7,Kalamazoo,MI,10-04-2016,957,217,5913,6632,93,International,8,2016-04-03,2016-04-10,4,3,719,7 days,3214192,2872849
5,10006,1,4,O-job,03-04-2016,Detriot,MI,4,Monon,IN,07-04-2016,332,332,4687,3084,68,Domestic,4,2016-04-03,2016-04-07,4,3,-1603,4 days,3217276,2877536
1511,11512,3,4,Dingity,03-04-2016,Appleton,WI,10,Grand Rapids,MI,15-04-2016,336,336,6735,4483,72,International,5,2016-04-03,2016-04-15,4,3,-2252,12 days,3221759,2884271
1131,11132,3,2,Y-strip,03-04-2016,Green Bay,WI,10,Joliet,IL,10-04-2016,1031,205,554,921,79,International,5,2016-04-03,2016-04-10,4,3,367,7 days,3222680,2884825
1619,11620,3,2,Joyancom,03-04-2016,Appleton,WI,7,Grand Rapids,MI,12-04-2016,815,781,3242,3489,60,International,2,2016-04-03,2016-04-12,4,3,247,9 days,3226169,2888067
278,10279,2,4,Tantechi,03-04-2016,Monon,IN,3,Lansing,MI,06-04-2016,996,731,6170,4854,93,Domestic,5,2016-04-03,2016-04-06,4,3,-1316,3 days,3231023,2894237
565,10566,1,6,zen-holdings,04-04-2016,Rockford,IL,2,Green Bay,WI,06-04-2016,591,291,228,744,61,Domestic,7,2016-04-04,2016-04-06,4,4,516,2 days,3231767,2894465
128,10129,2,5,D-zohex,04-04-2016,Northbrook,IL,10,Naperville,IL,14-04-2016,365,365,7742,8060,90,International,9,2016-04-04,2016-04-14,4,4,318,10 days,3239827,2902207
21,10022,2,6,zotit,04-04-2016,Milwaukee,WI,2,Springfield,IL,06-04-2016,1068,267,88,911,73,Domestic,7,2016-04-04,2016-04-06,4,4,823,2 days,3240738,2902295
805,10806,2,5,Technodax,04-04-2016,Rockford,IL,3,Green Bay,WI,07-04-2016,549,474,6240,6882,58,Domestic,5,2016-04-04,2016-04-07,4,4,642,3 days,3247620,2908535
1371,11372,2,4,Yearcorporation,04-04-2016,Indianapolis,IN,1,Northbrook,IL,05-04-2016,408,388,4039,2189,76,Domestic,2,2016-04-04,2016-04-05,4,4,-1850,1 days,3249809,2912574
1420,11421,2,2,zathhow,05-04-2016,Green Bay,WI,8,Joliet,IL,13-04-2016,811,559,8443,8936,51,International,6,2016-04-05,2016-04-13,4,5,493,8 days,3258745,2921017
1259,11260,2,4,Zimity,05-04-2016,Detriot,MI,7,Monon,IN,10-04-2016,515,431,4241,1864,55,International,8,2016-04-05,2016-04-10,4,5,-2377,5 days,3260609,2925258
1018,11019,2,4,Joyancom,05-04-2016,Detriot,MI,1,Monon,IN,06-04-2016,818,743,7496,6308,67,Intercom,1,2016-04-05,2016-04-06,4,5,-1188,1 days,3266917,2932754
490,10491,1,8,Zoomhex,05-04-2016,Davenport,IA,5,Appleton,WI,10-04-2016,1104,679,6931,7665,89,International,5,2016-04-05,2016-04-10,4,5,734,5 days,3274582,2939685
346,10347,1,4,Sunjob,05-04-2016,Rockford,IL,4,Green Bay,WI,09-04-2016,623,623,5041,2847,70,Domestic,10,2016-04-05,2016-04-09,4,5,-2194,4 days,3277429,2944726
833,10834,2,4,Y-strip,05-04-2016,Bangor,MI,6,Davenport,IA,11-04-2016,212,212,8274,6710,53,International,7,2016-04-05,2016-04-11,4,5,-1564,6 days,3284139,2953000
1200,11201,2,4,Ganjazone,06-04-2016,Naperville,IL,6,Indianapolis,IN,12-04-2016,955,452,4082,2891,95,International,8,2016-04-06,2016-04-12,4,6,-1191,6 days,3287030,2957082
1161,11162,3,6,Redozetam,06-04-2016,Bangor,MI,10,Davenport,IA,16-04-2016,662,564,6958,7307,64,International,5,2016-04-06,2016-04-16,4,6,349,10 days,3294337,2964040
1116,11117,3,3,zathhow,06-04-2016,Bangor,MI,1,Davenport,IA,07-04-2016,846,235,1348,1895,60,Domestic,5,2016-04-06,2016-04-07,4,6,547,1 days,3296232,2965388
860,10861,1,5,Itcantrans,06-04-2016,Davenport,IA,10,Appleton,WI,13-04-2016,1100,351,7715,7855,61,International,3,2016-04-06,2016-04-13,4,6,140,7 days,3304087,2973103
1242,11243,2,2,Goldenbam,06-04-2016,Monon,IN,4,Lansing,MI,10-04-2016,859,685,7977,8519,77,Domestic,1,2016-04-06,2016-04-10,4,6,542,4 days,3312606,2981080
561,10562,2,7,Unahigh,06-04-2016,Monon,IN,8,Lansing,MI,21-03-2016,560,560,101,574,63,International,5,2016-04-06,2016-03-21,4,6,473,-16 days,3313180,2981181
709,10710,2,6,Donglax,07-04-2016,Davenport,IA,5,Appleton,WI,12-04-2016,766,536,1314,2224,80,International,4,2016-04-07,2016-04-12,4,7,910,5 days,3315404,2982495
1077,11078,3,1,Citytone,07-04-2016,Milwaukee,WI,2,Springfield,IL,09-04-2016,1156,320,5917,9561,97,Domestic,8,2016-04-07,2016-04-09,4,7,3644,2 days,3324965,2988412
678,10679,1,8,Duo-fase,07-04-2016,Appleton,WI,10,Grand Rapids,MI,16-04-2016,537,522,4026,4631,64,International,2,2016-04-07,2016-04-16,4,7,605,9 days,3329596,2992438
1530,11531,2,1,Matdex,07-04-2016,Monon,IN,6,Lansing,MI,14-04-2016,939,529,2982,7861,99,International,4,2016-04-07,2016-04-14,4,7,4879,7 days,3337457,2995420
249,10250,2,6,Roundlam,07-04-2016,Springfield,IL,9,Skokie,IL,16-04-2016,806,262,6351,6620,91,International,6,2016-04-07,2016-04-16,4,7,269,9 days,3344077,3001771
789,10790,1,8,Qvofix,07-04-2016,Toledo,OH,1,Detriot,MI,08-04-2016,1005,592,8072,8935,67,Domestic,7,2016-04-07,2016-04-08,4,7,863,1 days,3353012,3009843
368,10369,1,7,Rancan,08-04-2016,Appleton,WI,3,Grand Rapids,MI,11-04-2016,787,787,5635,6057,60,Domestic,7,2016-04-08,2016-04-11,4,8,422,3 days,3359069,3015478
8,10009,2,6,san-plex,08-04-2016,Monon,IN,10,Lansing,MI,18-04-2016,804,663,3746,4107,90,International,4,2016-04-08,2016-04-18,4,8,361,10 days,3363176,3019224
1599,11600,2,5,Zimjiit,08-04-2016,Cincinnati,OH,3,Gary,IN,11-04-2016,504,286,2404,2710,52,Domestic,7,2016-04-08,2016-04-11,4,8,306,3 days,3365886,3021628
1384,11385,3,5,Alphafan,09-04-2016,Lansing,MI,8,Dayton,OH,17-04-2016,590,590,6088,6198,96,International,2,2016-04-09,2016-04-17,4,9,110,8 days,3372084,3027716
264,10265,2,4,openzap,09-04-2016,Lansing,MI,2,Dayton,OH,11-04-2016,728,728,8452,6119,98,Domestic,7,2016-04-09,2016-04-11,4,9,-2333,2 days,3378203,3036168
33,10034,1,5,applanet,09-04-2016,Cincinnati,OH,7,Gary,IN,14-04-2016,220,220,4984,5421,71,International,5,2016-04-09,2016-04-14,4,9,437,5 days,3383624,3041152
1023,11024,2,5,Flexplex,10-04-2016,Green Bay,WI,5,Joliet,IL,14-04-2016,1181,342,5346,6335,57,International,10,2016-04-10,2016-04-14,4,10,989,4 days,3389959,3046498
1246,11247,2,2,Sunjob,10-04-2016,Rockford,IL,2,Green Bay,WI,12-04-2016,1035,384,2623,3414,100,Domestic,8,2016-04-10,2016-04-12,4,10,791,2 days,3393373,3049121
1594,11595,3,2,K-antex,10-04-2016,Madison,WI,4,Kalamazoo,MI,14-04-2016,355,355,6501,6932,92,Domestic,4,2016-04-10,2016-04-14,4,10,431,4 days,3400305,3055622
1671,11672,3,5,Medcan,10-04-2016,Milwaukee,WI,10,Springfield,IL,20-04-2016,474,474,3816,4247,57,International,8,2016-04-10,2016-04-20,4,10,431,10 days,3404552,3059438
787,10788,1,8,Zoomhex,10-04-2016,Cincinnati,OH,6,Gary,IN,15-04-2016,768,693,7359,7501,50,International,2,2016-04-10,2016-04-15,4,10,142,5 days,3412053,3066797
903,10904,2,2,Ganjazone,10-04-2016,Elgin,IL,3,Cincinnati,OH,13-04-2016,763,713,7500,7877,62,Domestic,5,2016-04-10,2016-04-13,4,10,377,3 days,3419930,3074297
1451,11452,3,1,Jaydox,11-04-2016,Skokie,IL,2,Chicago,IL,13-04-2016,271,271,1892,6159,69,Domestic,1,2016-04-11,2016-04-13,4,11,4267,2 days,3426089,3076189
1463,11464,3,4,openzap,11-04-2016,Madison,WI,9,Kalamazoo,MI,18-04-2016,1040,448,6135,4100,52,International,9,2016-04-11,2016-04-18,4,11,-2035,7 days,3430189,3082324
1625,11626,3,1,Cityis,11-04-2016,Skokie,IL,1,Chicago,IL,12-04-2016,406,406,8073,12642,74,Domestic,8,2016-04-11,2016-04-12,4,11,4569,1 days,3442831,3090397
1125,11126,2,6,Streetlam,11-04-2016,Northbrook,IL,8,Naperville,IL,21-03-2016,279,262,7859,8810,68,International,2,2016-04-11,2016-03-21,4,11,951,-21 days,3451641,3098256
428,10429,2,7,Bluezoombam,11-04-2016,Indianapolis,IN,2,Northbrook,IL,13-04-2016,994,291,2844,3108,82,Domestic,10,2016-04-11,2016-04-13,4,11,264,2 days,3454749,3101100
1140,11141,2,6,Saocity,11-04-2016,Skokie,IL,9,Chicago,IL,20-04-2016,483,211,4834,5155,93,International,5,2016-04-11,2016-04-20,4,11,321,9 days,3459904,3105934
273,10274,2,4,Viacane,11-04-2016,Chicago,IL,2,Rockford,IL,13-04-2016,482,482,6815,4337,87,Domestic,10,2016-04-11,2016-04-13,4,11,-2478,2 days,3464241,3112749
539,10540,1,5,Truebam,11-04-2016,Detriot,MI,3,Monon,IN,14-04-2016,1025,480,2163,3047,55,Domestic,3,2016-04-11,2016-04-14,4,11,884,3 days,3467288,3114912
861,10862,1,2,Blue-tech,11-04-2016,Grand Rapids,MI,4,Toledo,OH,12-04-2016,498,498,4017,4431,78,Domestic,3,2016-04-11,2016-04-12,4,11,414,1 days,3471719,3118929
308,10309,1,5,Stimmedia,11-04-2016,Bangor,MI,3,Davenport,IA,14-04-2016,980,767,5221,5395,65,Domestic,10,2016-04-11,2016-04-14,4,11,174,3 days,3477114,3124150
1354,11355,2,3,Zerlane,11-04-2016,Green Bay,WI,5,Joliet,IL,13-04-2016,609,609,722,1323,82,International,9,2016-04-11,2016-04-13,4,11,601,2 days,3478437,3124872
56,10057,2,7,silfase,11-04-2016,Lansing,MI,4,Dayton,OH,15-04-2016,1002,735,6107,6447,62,Domestic,10,2016-04-11,2016-04-15,4,11,340,4 days,3484884,3130979
311,10312,2,8,Dingity,11-04-2016,Kalamazoo,MI,10,Bangor,MI,18-04-2016,958,477,7558,8307,61,International,6,2016-04-11,2016-04-18,4,11,749,7 days,3493191,3138537
1731,11732,3,4,Plustaxon,11-04-2016,Skokie,IL,1,Chicago,IL,12-04-2016,266,266,3601,1554,54,Domestic,3,2016-04-11,2016-04-12,4,11,-2047,1 days,3494745,3142138
1784,11785,2,5,Viatom,11-04-2016,Indianapolis,IN,10,Northbrook,IL,21-04-2016,1007,781,617,1411,59,International,6,2016-04-11,2016-04-21,4,11,794,10 days,3496156,3142755
356,10357,2,4,Dontam,11-04-2016,Springfield,IL,6,Skokie,IL,17-04-2016,1152,568,6702,4978,94,International,2,2016-04-11,2016-04-17,4,11,-1724,6 days,3501134,3149457
605,10606,2,5,K-is,12-04-2016,Gary,IN,6,Milwaukee,WI,17-04-2016,663,350,6747,7370,80,International,2,2016-04-12,2016-04-17,4,12,623,5 days,3508504,3156204
939,10940,2,3,Howplanet,12-04-2016,Green Bay,WI,3,Joliet,IL,15-04-2016,318,318,1859,2231,90,Domestic,7,2016-04-12,2016-04-15,4,12,372,3 days,3510735,3158063
1706,11707,3,4,Sonbam,12-04-2016,Lansing,MI,5,Dayton,OH,17-04-2016,717,717,3108,977,71,International,2,2016-04-12,2016-04-17,4,12,-2131,5 days,3511712,3161171
1578,11579,2,1,Duo-fase,12-04-2016,Appleton,WI,4,Grand Rapids,MI,16-04-2016,503,503,2950,7266,71,Domestic,3,2016-04-12,2016-04-16,4,12,4316,4 days,3518978,3164121
1294,11295,3,1,Quotefix,12-04-2016,Elgin,IL,3,Cincinnati,OH,15-04-2016,210,210,3154,8241,77,Domestic,8,2016-04-12,2016-04-15,4,12,5087,3 days,3527219,3167275
1766,11767,2,5,Zamlane,12-04-2016,Madison,WI,2,Kalamazoo,MI,14-04-2016,481,481,2189,2923,64,Intercom,1,2016-04-12,2016-04-14,4,12,734,2 days,3530142,3169464
1232,11233,2,6,Instrip,12-04-2016,Kalamazoo,MI,3,Bangor,MI,15-04-2016,871,642,912,1394,78,Domestic,3,2016-04-12,2016-04-15,4,12,482,3 days,3531536,3170376
717,10718,2,6,Laex,12-04-2016,Joliet,IL,1,Madison,WI,12-04-2016,254,254,6575,7232,91,Domestic,5,2016-04-12,2016-04-12,4,12,657,0 days,3538768,3176951
548,10549,2,6,betaity,12-04-2016,Elgin,IL,1,Cincinnati,OH,12-04-2016,714,714,2032,2976,59,Domestic,5,2016-04-12,2016-04-12,4,12,944,0 days,3541744,3178983
1101,11102,3,5,hotity,13-04-2016,Springfield,IL,1,Skokie,IL,14-04-2016,303,303,3886,4247,61,Domestic,5,2016-04-13,2016-04-14,4,13,361,1 days,3545991,3182869
1183,11184,3,1,Plustax,13-04-2016,Toledo,OH,6,Detriot,MI,21-03-2016,256,256,6334,11409,98,International,7,2016-04-13,2016-03-21,4,13,5075,-23 days,3557400,3189203
286,10287,2,4,Quotelane,13-04-2016,Bangor,MI,5,Davenport,IA,18-04-2016,465,465,5225,3538,62,International,2,2016-04-13,2016-04-18,4,13,-1687,5 days,3560938,3194428
1215,11216,3,6,Solholdings,13-04-2016,Chicago,IL,3,Rockford,IL,16-04-2016,256,256,2151,2842,50,Domestic,2,2016-04-13,2016-04-16,4,13,691,3 days,3563780,3196579
32,10033,1,7,Technoline,13-04-2016,Appleton,WI,7,Grand Rapids,MI,18-04-2016,435,435,1762,2342,89,International,2,2016-04-13,2016-04-18,4,13,580,5 days,3566122,3198341
327,10328,1,5,Groovestrip,13-04-2016,Dayton,OH,3,Elgin,IL,16-04-2016,312,312,7048,7815,92,Domestic,4,2016-04-13,2016-04-16,4,13,767,3 days,3573937,3205389
771,10772,1,4,Planetware,13-04-2016,Kalamazoo,MI,3,Bangor,MI,16-04-2016,472,472,8048,6114,57,Domestic,6,2016-04-13,2016-04-16,4,13,-1934,3 days,3580051,3213437
362,10363,2,5,J-lax,13-04-2016,Joliet,IL,2,Madison,WI,15-04-2016,836,530,4154,4766,56,Domestic,10,2016-04-13,2016-04-15,4,13,612,2 days,3584817,3217591
1303,11304,3,1,Xx-planet,14-04-2016,Northbrook,IL,2,Naperville,IL,16-04-2016,592,592,8507,12806,56,Domestic,4,2016-04-14,2016-04-16,4,14,4299,2 days,3597623,3226098
696,10697,2,5,K-antex,14-04-2016,Madison,WI,6,Kalamazoo,MI,19-04-2016,553,553,4077,4990,63,International,6,2016-04-14,2016-04-19,4,14,913,5 days,3602613,3230175
314,10315,2,8,Planethouse,14-04-2016,Milwaukee,WI,1,Springfield,IL,15-04-2016,716,716,2311,3104,52,Domestic,4,2016-04-14,2016-04-15,4,14,793,1 days,3605717,3232486
1549,11550,2,4,Sunjob,14-04-2016,Northbrook,IL,7,Naperville,IL,24-04-2016,536,536,6667,3860,71,International,10,2016-04-14,2016-04-24,4,14,-2807,10 days,3609577,3239153
1073,11074,2,2,Toncode,14-04-2016,Skokie,IL,3,Chicago,IL,17-04-2016,904,587,1292,2076,82,Domestic,1,2016-04-14,2016-04-17,4,14,784,3 days,3611653,3240445
1111,11112,3,1,Linezatlam,15-04-2016,Appleton,WI,8,Grand Rapids,MI,22-04-2016,704,330,5386,9762,57,International,5,2016-04-15,2016-04-22,4,15,4376,7 days,3621415,3245831
1792,11793,2,2,Subdrill,15-04-2016,Rockford,IL,3,Green Bay,WI,18-04-2016,632,239,229,990,65,Domestic,3,2016-04-15,2016-04-18,4,15,761,3 days,3622405,3246060
186,10187,1,8,Citytone,15-04-2016,Milwaukee,WI,1,Springfield,IL,16-04-2016,347,347,91,942,64,Domestic,7,2016-04-15,2016-04-16,4,15,851,1 days,3623347,3246151
210,10211,1,5,Technodax,15-04-2016,Northbrook,IL,1,Naperville,IL,16-04-2016,599,485,736,1424,98,Domestic,10,2016-04-15,2016-04-16,4,15,688,1 days,3624771,3246887
313,10314,2,8,Duodax,15-04-2016,Grand Rapids,MI,4,Toledo,OH,17-04-2016,510,510,3950,4763,98,Domestic,5,2016-04-15,2016-04-17,4,15,813,2 days,3629534,3250837
924,10925,2,3,Canemedkix,15-04-2016,Toledo,OH,4,Detriot,MI,19-04-2016,822,367,7855,8306,95,Domestic,8,2016-04-15,2016-04-19,4,15,451,4 days,3637840,3258692
326,10327,1,6,Sonlex,15-04-2016,Cincinnati,OH,4,Gary,IN,19-04-2016,1121,572,5114,5274,86,Domestic,1,2016-04-15,2016-04-19,4,15,160,4 days,3643114,3263806
836,10837,1,7,Truebam,15-04-2016,Kalamazoo,MI,1,Bangor,MI,16-04-2016,998,302,4291,4453,81,Intercom,5,2016-04-15,2016-04-16,4,15,162,1 days,3647567,3268097
242,10243,2,6,Dongbase,16-04-2016,Toledo,OH,3,Detriot,MI,19-04-2016,800,247,2889,3764,61,Domestic,9,2016-04-16,2016-04-19,4,16,875,3 days,3651331,3270986
304,10305,1,8,Keyzunbase,16-04-2016,Appleton,WI,10,Grand Rapids,MI,26-04-2016,1154,753,7830,8630,77,International,3,2016-04-16,2016-04-26,4,16,800,10 days,3659961,3278816
1492,11493,2,6,Dentocity,16-04-2016,Lansing,MI,6,Dayton,OH,24-04-2016,752,288,7404,7592,69,International,3,2016-04-16,2016-04-24,4,16,188,8 days,3667553,3286220
601,10602,2,7,Recode,16-04-2016,Chicago,IL,3,Rockford,IL,19-04-2016,271,209,5902,6462,79,Domestic,10,2016-04-16,2016-04-19,4,16,560,3 days,3674015,3292122
508,10509,1,8,Technodax,16-04-2016,Skokie,IL,5,Chicago,IL,21-03-2016,653,624,3442,4094,66,International,1,2016-04-16,2016-03-21,4,16,652,-26 days,3678109,3295564
153,10154,2,5,Stimcore,16-04-2016,Madison,WI,10,Kalamazoo,MI,24-04-2016,1047,476,1367,1811,96,International,10,2016-04-16,2016-04-24,4,16,444,8 days,3679920,3296931
1109,11110,2,2,Faxzumtrax,16-04-2016,Naperville,IL,1,Indianapolis,IN,17-04-2016,862,395,6527,7415,65,Domestic,2,2016-04-16,2016-04-17,4,16,888,1 days,3687335,3303458
947,10948,3,5,Sunjob,16-04-2016,Skokie,IL,8,Chicago,IL,21-03-2016,937,794,7473,8465,57,International,9,2016-04-16,2016-03-21,4,16,992,-26 days,3695800,3310931
968,10969,2,3,Singleholdings,16-04-2016,Davenport,IA,8,Appleton,WI,23-04-2016,886,724,5315,6180,67,International,2,2016-04-16,2016-04-23,4,16,865,7 days,3701980,3316246
334,10335,1,4,zoofan,16-04-2016,Milwaukee,WI,3,Springfield,IL,19-04-2016,1101,206,7533,5369,65,Domestic,1,2016-04-16,2016-04-19,4,16,-2164,3 days,3707349,3323779
1281,11282,3,3,Ranmedia,16-04-2016,Northbrook,IL,4,Naperville,IL,20-04-2016,1105,792,7358,8158,69,Domestic,5,2016-04-16,2016-04-20,4,16,800,4 days,3715507,3331137
780,10781,2,4,Alphadax,17-04-2016,Joliet,IL,8,Madison,WI,25-04-2016,312,312,7766,6286,97,International,1,2016-04-17,2016-04-25,4,17,-1480,8 days,3721793,3338903
766,10767,1,6,Zumcane,17-04-2016,Toledo,OH,1,Detriot,MI,18-04-2016,340,340,3149,3885,96,Domestic,3,2016-04-17,2016-04-18,4,17,736,1 days,3725678,3342052
481,10482,1,4,Rankphase,17-04-2016,Appleton,WI,2,Grand Rapids,MI,19-04-2016,968,374,7960,5505,79,Domestic,2,2016-04-17,2016-04-19,4,17,-2455,2 days,3731183,3350012
1476,11477,3,6,Linetone,17-04-2016,Grand Rapids,MI,5,Toledo,OH,24-04-2016,267,267,126,733,62,International,3,2016-04-17,2016-04-24,4,17,607,7 days,3731916,3350138
815,10816,1,6,O-ace,18-04-2016,Davenport,IA,9,Appleton,WI,27-04-2016,348,348,6092,6643,66,International,2,2016-04-18,2016-04-27,4,18,551,9 days,3738559,3356230
1587,11588,2,3,roundphase,18-04-2016,Grand Rapids,MI,7,Toledo,OH,28-04-2016,342,220,2982,3670,66,International,2,2016-04-18,2016-04-28,4,18,688,10 days,3742229,3359212
840,10841,1,4,Howelectrics,18-04-2016,Springfield,IL,8,Skokie,IL,24-04-2016,379,379,3381,1797,62,International,8,2016-04-18,2016-04-24,4,18,-1584,6 days,3744026,3362593
1393,11394,3,3,Golddexon,18-04-2016,Northbrook,IL,3,Naperville,IL,21-04-2016,887,220,1309,1843,90,Domestic,7,2016-04-18,2016-04-21,4,18,534,3 days,3745869,3363902
1482,11483,2,2,Latcore,18-04-2016,Gary,IN,7,Milwaukee,WI,24-04-2016,886,771,3957,4876,97,International,1,2016-04-18,2016-04-24,4,18,919,6 days,3750745,3367859
1339,11340,3,6,Y-zoom,18-04-2016,Elgin,IL,2,Cincinnati,OH,20-04-2016,1078,511,2741,3093,93,Domestic,2,2016-04-18,2016-04-20,4,18,352,2 days,3753838,3370600
1553,11554,3,5,Kincorporation,18-04-2016,Monon,IN,5,Lansing,MI,21-03-2016,383,383,1632,2310,64,International,7,2016-04-18,2016-03-21,4,18,678,-28 days,3756148,3372232
375,10376,2,7,Zamholdings,18-04-2016,Skokie,IL,7,Chicago,IL,25-04-2016,834,569,571,1395,95,International,7,2016-04-18,2016-04-25,4,18,824,7 days,3757543,3372803
402,10403,1,6,Scotcan,18-04-2016,Grand Rapids,MI,2,Toledo,OH,20-04-2016,459,459,2137,2948,67,Domestic,4,2016-04-18,2016-04-20,4,18,811,2 days,3760491,3374940
1039,11040,3,2,Faseron,19-04-2016,Detriot,MI,5,Monon,IN,21-04-2016,996,262,2234,3176,73,International,6,2016-04-19,2016-04-21,4,19,942,2 days,3763667,3377174
487,10488,1,6,Funlatlex,19-04-2016,Elgin,IL,2,Cincinnati,OH,20-04-2016,446,446,6336,7212,66,Domestic,9,2016-04-19,2016-04-20,4,19,876,1 days,3770879,3383510
1092,11093,3,5,white-high,19-04-2016,Toledo,OH,2,Detriot,MI,21-04-2016,744,637,661,1262,88,Domestic,4,2016-04-19,2016-04-21,4,19,601,2 days,3772141,3384171
1104,11105,3,3,re-can,19-04-2016,Detriot,MI,8,Monon,IN,27-04-2016,731,441,1473,1787,91,International,2,2016-04-19,2016-04-27,4,19,314,8 days,3773928,3385644
1432,11433,2,5,Jobtechnology,19-04-2016,Milwaukee,WI,4,Springfield,IL,23-04-2016,833,461,1823,2493,77,Domestic,3,2016-04-19,2016-04-23,4,19,670,4 days,3776421,3387467
102,10103,2,7,Whitekix,19-04-2016,Grand Rapids,MI,4,Toledo,OH,20-04-2016,981,619,3440,4129,89,Domestic,8,2016-04-19,2016-04-20,4,19,689,1 days,3780550,3390907
703,10704,1,6,Duoflex,19-04-2016,Toledo,OH,2,Detriot,MI,21-04-2016,929,518,912,1324,79,Domestic,2,2016-04-19,2016-04-21,4,19,412,2 days,3781874,3391819
15,10016,1,5,tampquote,19-04-2016,Lansing,MI,9,Dayton,OH,26-04-2016,328,328,37,736,94,International,1,2016-04-19,2016-04-26,4,19,699,7 days,3782610,3391856
206,10207,1,8,Latgotrax,20-04-2016,Milwaukee,WI,2,Springfield,IL,22-04-2016,939,685,1198,2094,63,Domestic,9,2016-04-20,2016-04-22,4,20,896,2 days,3784704,3393054
1417,11418,3,5,Statway,20-04-2016,Joliet,IL,2,Madison,WI,21-04-2016,336,305,7958,8594,66,Domestic,10,2016-04-20,2016-04-21,4,20,636,1 days,3793298,3401012
1271,11272,2,4,Condintex,20-04-2016,Lansing,MI,10,Dayton,OH,30-04-2016,804,257,1907,27,53,International,3,2016-04-20,2016-04-30,4,20,-1880,10 days,3793325,3402919
36,10037,2,7,Strongdax,20-04-2016,Bangor,MI,3,Davenport,IA,23-04-2016,726,348,919,1084,85,Domestic,6,2016-04-20,2016-04-23,4,20,165,3 days,3794409,3403838
892,10893,2,4,san-plex,21-04-2016,Monon,IN,7,Lansing,MI,21-03-2016,655,438,2346,274,58,International,5,2016-04-21,2016-03-21,4,21,-2072,-31 days,3794683,3406184
908,10909,1,5,zotit,21-04-2016,Milwaukee,WI,6,Springfield,IL,27-04-2016,471,471,6110,7050,54,International,5,2016-04-21,2016-04-27,4,21,940,6 days,3801733,3412294
1788,11789,2,2,san-plex,21-04-2016,Monon,IN,1,Lansing,MI,22-04-2016,529,529,7671,7864,93,Domestic,4,2016-04-21,2016-04-22,4,21,193,1 days,3809597,3419965
1137,11138,2,2,Dongbase,21-04-2016,Toledo,OH,3,Detriot,MI,24-04-2016,571,238,3966,4608,61,Domestic,6,2016-04-21,2016-04-24,4,21,642,3 days,3814205,3423931
636,10637,2,5,Zaamhouse,21-04-2016,Dayton,OH,10,Elgin,IL,01-05-2016,438,212,4807,5400,93,International,4,2016-04-21,2016-05-01,4,21,593,10 days,3819605,3428738
390,10391,2,8,Aptaxon,21-04-2016,Naperville,IL,1,Indianapolis,IN,22-04-2016,648,417,6274,6733,81,Domestic,10,2016-04-21,2016-04-22,4,21,459,1 days,3826338,3435012
730,10731,1,7,stripzim,21-04-2016,Grand Rapids,MI,4,Toledo,OH,25-04-2016,241,241,1601,2570,94,Domestic,8,2016-04-21,2016-04-25,4,21,969,4 days,3828908,3436613
1487,11488,3,3,Viatom,21-04-2016,Naperville,IL,2,Indianapolis,IN,25-04-2016,868,349,7410,8258,88,Domestic,6,2016-04-21,2016-04-25,4,21,848,4 days,3837166,3444023
1328,11329,2,6,Dingquokix,22-04-2016,Monon,IN,6,Lansing,MI,21-03-2016,791,551,5388,5895,60,International,6,2016-04-22,2016-03-21,4,22,507,-32 days,3843061,3449411
695,10696,1,8,Streetplus,22-04-2016,Monon,IN,2,Lansing,MI,24-04-2016,463,384,6905,7336,95,Domestic,5,2016-04-22,2016-04-24,4,22,431,2 days,3850397,3456316
408,10409,1,4,apzone,22-04-2016,Detriot,MI,1,Monon,IN,23-04-2016,451,451,8713,6285,61,Domestic,6,2016-04-22,2016-04-23,4,22,-2428,1 days,3856682,3465029
167,10168,1,6,Ontohatron,22-04-2016,Springfield,IL,1,Skokie,IL,23-04-2016,600,281,859,1174,94,Intercom,7,2016-04-22,2016-04-23,4,22,315,1 days,3857856,3465888
1683,11684,2,4,Tripple-fax,22-04-2016,Dayton,OH,4,Elgin,IL,26-04-2016,749,509,6888,4851,93,Domestic,6,2016-04-22,2016-04-26,4,22,-2037,4 days,3862707,3472776
1228,11229,2,4,Saohow,23-04-2016,Lansing,MI,3,Dayton,OH,26-04-2016,394,394,4583,2468,79,Domestic,7,2016-04-23,2016-04-26,4,23,-2115,3 days,3865175,3477359
1732,11733,3,6,Truebam,23-04-2016,Kalamazoo,MI,8,Bangor,MI,29-04-2016,230,230,8751,8870,52,International,2,2016-04-23,2016-04-29,4,23,119,6 days,3874045,3486110
1422,11423,3,5,Donelectrics,23-04-2016,Cincinnati,OH,2,Gary,IN,25-04-2016,279,231,579,999,79,Domestic,9,2016-04-23,2016-04-25,4,23,420,2 days,3875044,3486689
1121,11122,3,3,Namelectronics,23-04-2016,Milwaukee,WI,9,Springfield,IL,02-05-2016,384,361,498,1465,57,International,9,2016-04-23,2016-05-02,4,23,967,9 days,3876509,3487187
1225,11226,3,6,Sanin,23-04-2016,Appleton,WI,7,Grand Rapids,MI,29-04-2016,388,388,4091,4729,91,International,5,2016-04-23,2016-04-29,4,23,638,6 days,3881238,3491278
738,10739,1,5,Ozeris,23-04-2016,Madison,WI,1,Kalamazoo,MI,24-04-2016,334,253,7858,8394,91,Domestic,8,2016-04-23,2016-04-24,4,23,536,1 days,3889632,3499136
1461,11462,3,1,Blue-tech,23-04-2016,Joliet,IL,4,Madison,WI,27-04-2016,971,795,5143,9604,60,Domestic,6,2016-04-23,2016-04-27,4,23,4461,4 days,3899236,3504279
418,10419,2,5,Tantax,23-04-2016,Toledo,OH,8,Detriot,MI,21-03-2016,865,238,2490,2670,71,International,5,2016-04-23,2016-03-21,4,23,180,-33 days,3901906,3506769
1364,11365,2,5,geohigh,24-04-2016,Skokie,IL,8,Chicago,IL,02-05-2016,339,266,6599,7397,54,International,1,2016-04-24,2016-05-02,4,24,798,8 days,3909303,3513368
1631,11632,3,5,Y-flex,24-04-2016,Chicago,IL,4,Rockford,IL,28-04-2016,437,374,5763,6748,62,Domestic,1,2016-04-24,2016-04-28,4,24,985,4 days,3916051,3519131
812,10813,1,5,Faxzumtrax,24-04-2016,Elgin,IL,4,Cincinnati,OH,25-04-2016,1118,613,7710,7959,60,Domestic,4,2016-04-24,2016-04-25,4,24,249,1 days,3924010,3526841
187,10188,2,6,Alphafan,25-04-2016,Springfield,IL,7,Skokie,IL,01-05-2016,735,735,822,1725,78,International,7,2016-04-25,2016-05-01,4,25,903,6 days,3925735,3527663
190,10191,2,6,wareholding,25-04-2016,Northbrook,IL,4,Naperville,IL,29-04-2016,441,441,64,546,98,Domestic,1,2016-04-25,2016-04-29,4,25,482,4 days,3926281,3527727
4,10005,1,4,Silverfase,25-04-2016,Northbrook,IL,3,Naperville,IL,28-04-2016,514,205,7647,5456,60,Domestic,2,2016-04-25,2016-04-28,4,25,-2191,3 days,3931737,3535374
1180,11181,3,3,Funfintech,25-04-2016,Appleton,WI,7,Grand Rapids,MI,02-05-2016,224,224,6092,6819,89,International,4,2016-04-25,2016-05-02,4,25,727,7 days,3938556,3541466
1142,11143,3,1,Silver-line,25-04-2016,Davenport,IA,5,Appleton,WI,30-04-2016,1171,726,7699,12593,52,International,3,2016-04-25,2016-04-30,4,25,4894,5 days,3951149,3549165
1571,11572,2,3,Vaiataxon,25-04-2016,Indianapolis,IN,7,Northbrook,IL,05-05-2016,871,283,3019,3537,94,International,8,2016-04-25,2016-05-05,4,25,518,10 days,3954686,3552184
1106,11107,2,3,ganz-is,25-04-2016,Monon,IN,6,Lansing,MI,21-03-2016,766,314,5853,5965,58,International,6,2016-04-25,2016-03-21,4,25,112,-35 days,3960651,3558037
585,10586,1,7,bamity,25-04-2016,Madison,WI,6,Kalamazoo,MI,30-04-2016,343,343,7993,8557,79,International,3,2016-04-25,2016-04-30,4,25,564,5 days,3969208,3566030
555,10556,1,6,citydexon,26-04-2016,Chicago,IL,3,Rockford,IL,29-04-2016,1046,374,3336,3821,96,Domestic,4,2016-04-26,2016-04-29,4,26,485,3 days,3973029,3569366
1380,11381,2,2,Rankphase,26-04-2016,Appleton,WI,3,Grand Rapids,MI,29-04-2016,1089,588,1301,1993,70,Domestic,4,2016-04-26,2016-04-29,4,26,692,3 days,3975022,3570667
1241,11242,3,6,Greentech,26-04-2016,Joliet,IL,1,Madison,WI,27-04-2016,681,681,1580,1840,81,Domestic,3,2016-04-26,2016-04-27,4,26,260,1 days,3976862,3572247
1188,11189,3,6,O-job,26-04-2016,Kalamazoo,MI,10,Bangor,MI,04-05-2016,624,528,6944,7674,75,International,2,2016-04-26,2016-05-04,4,26,730,8 days,3984536,3579191
409,10410,2,4,Jaylane,26-04-2016,Joliet,IL,2,Madison,WI,28-04-2016,886,518,7594,5516,74,Domestic,9,2016-04-26,2016-04-28,4,26,-2078,2 days,3990052,3586785
1777,11778,2,6,Bamgeohigh,26-04-2016,Skokie,IL,2,Chicago,IL,28-04-2016,999,580,1972,2870,53,Domestic,2,2016-04-26,2016-04-28,4,26,898,2 days,3992922,3588757
1268,11269,2,3,Singleholdings,26-04-2016,Cincinnati,OH,3,Gary,IN,29-04-2016,1054,441,4101,5092,89,Domestic,1,2016-04-26,2016-04-29,4,26,991,3 days,3998014,3592858
1327,11328,3,5,stripzim,26-04-2016,Joliet,IL,6,Madison,WI,02-05-2016,953,654,2196,3118,99,International,10,2016-04-26,2016-05-02,4,26,922,6 days,4001132,3595054
1656,11657,3,2,Scotline,27-04-2016,Gary,IN,8,Milwaukee,WI,05-05-2016,405,405,2536,2911,75,International,3,2016-04-27,2016-05-05,4,27,375,8 days,4004043,3597590
821,10822,1,4,Donelectrics,27-04-2016,Gary,IN,7,Milwaukee,WI,01-05-2016,916,302,3283,1708,63,International,8,2016-04-27,2016-05-01,4,27,-1575,4 days,4005751,3600873
19,10020,2,6,Keyzunbase,27-04-2016,Kalamazoo,MI,1,Bangor,MI,28-04-2016,1141,503,4886,5180,72,Domestic,9,2016-04-27,2016-04-28,4,27,294,1 days,4010931,3605759
105,10106,1,7,Constreet,27-04-2016,Chicago,IL,1,Rockford,IL,28-04-2016,1188,325,5105,5460,86,Domestic,3,2016-04-27,2016-04-28,4,27,355,1 days,4016391,3610864
1134,11135,3,6,Truebam,27-04-2016,Appleton,WI,3,Grand Rapids,MI,30-04-2016,860,330,486,858,84,Domestic,3,2016-04-27,2016-04-30,4,27,372,3 days,4017249,3611350
646,10647,1,5,Unoex,27-04-2016,Chicago,IL,3,Rockford,IL,30-04-2016,409,257,2195,2949,83,Domestic,8,2016-04-27,2016-04-30,4,27,754,3 days,4020198,3613545
1211,11212,3,6,Fax-ex,27-04-2016,Davenport,IA,3,Appleton,WI,30-04-2016,890,328,3403,4058,54,Domestic,6,2016-04-27,2016-04-30,4,27,655,3 days,4024256,3616948
491,10492,2,7,Qvofix,27-04-2016,Milwaukee,WI,9,Springfield,IL,21-03-2016,1017,421,5028,5342,86,International,7,2016-04-27,2016-03-21,4,27,314,-37 days,4029598,3621976
1685,11686,2,6,Solozap,27-04-2016,Elgin,IL,3,Cincinnati,OH,29-04-2016,320,320,5353,6261,72,Domestic,6,2016-04-27,2016-04-29,4,27,908,2 days,4035859,3627329
1678,11679,3,3,D-quadlux,28-04-2016,Green Bay,WI,7,Joliet,IL,03-05-2016,845,547,1248,1723,73,International,3,2016-04-28,2016-05-03,4,28,475,5 days,4037582,3628577
931,10932,3,2,Saohow,28-04-2016,Springfield,IL,2,Skokie,IL,30-04-2016,685,524,7150,7794,60,Intercom,2,2016-04-28,2016-04-30,4,28,644,2 days,4045376,3635727
1726,11727,3,4,dan-high,28-04-2016,Dayton,OH,8,Elgin,IL,06-05-2016,555,207,6611,4334,61,International,8,2016-04-28,2016-05-06,4,28,-2277,8 days,4049710,3642338
1791,11792,2,5,Damdexon,28-04-2016,Naperville,IL,3,Indianapolis,IN,28-04-2016,751,552,7541,8321,65,Domestic,4,2016-04-28,2016-04-28,4,28,780,0 days,4058031,3649879
870,10871,2,3,Finlux,28-04-2016,Monon,IN,5,Lansing,MI,03-05-2016,433,421,5900,6025,74,International,6,2016-04-28,2016-05-03,4,28,125,5 days,4064056,3655779
910,10911,2,4,Stimmedia,28-04-2016,Chicago,IL,6,Rockford,IL,04-05-2016,956,643,5256,3113,72,International,1,2016-04-28,2016-05-04,4,28,-2143,6 days,4067169,3661035
284,10285,1,4,Plustax,28-04-2016,Toledo,OH,8,Detriot,MI,06-05-2016,580,580,6512,4328,58,International,4,2016-04-28,2016-05-06,4,28,-2184,8 days,4071497,3667547
498,10499,1,8,Fasezoomfix,28-04-2016,Madison,WI,3,Kalamazoo,MI,01-05-2016,355,355,1138,1702,53,Domestic,5,2016-04-28,2016-05-01,4,28,564,3 days,4073199,3668685
1642,11643,2,2,Faseron,28-04-2016,Appleton,WI,1,Grand Rapids,MI,29-04-2016,898,313,4872,5745,72,Intercom,9,2016-04-28,2016-04-29,4,28,873,1 days,4078944,3673557
1392,11393,3,6,Solozap,28-04-2016,Indianapolis,IN,3,Northbrook,IL,29-04-2016,1170,381,5424,6057,65,Domestic,10,2016-04-28,2016-04-29,4,28,633,1 days,4085001,3678981
1450,11451,3,2,betaity,28-04-2016,Elgin,IL,2,Cincinnati,OH,30-04-2016,1031,541,6424,7035,84,Domestic,9,2016-04-28,2016-04-30,4,28,611,2 days,4092036,3685405
1078,11079,3,6,Alphafan,29-04-2016,Springfield,IL,3,Skokie,IL,02-05-2016,509,509,441,1171,53,Domestic,3,2016-04-29,2016-05-02,4,29,730,3 days,4093207,3685846
1449,11450,2,5,Canphase,29-04-2016,Bangor,MI,1,Davenport,IA,30-04-2016,675,542,7990,8539,93,Domestic,10,2016-04-29,2016-04-30,4,29,549,1 days,4101746,3693836
1074,11075,2,3,Rankphase,29-04-2016,Kalamazoo,MI,9,Bangor,MI,05-05-2016,484,484,2835,3590,83,International,10,2016-04-29,2016-05-05,4,29,755,6 days,4105336,3696671
282,10283,2,5,Latcore,29-04-2016,Cincinnati,OH,2,Gary,IN,01-05-2016,1188,240,3668,3822,59,Domestic,3,2016-04-29,2016-05-01,4,29,154,2 days,4109158,3700339
1722,11723,2,4,Ganzlane,29-04-2016,Naperville,IL,2,Indianapolis,IN,29-04-2016,406,406,8389,5510,56,Domestic,5,2016-04-29,2016-04-29,4,29,-2879,0 days,4114668,3708728
1757,11758,3,6,Blue-tech,29-04-2016,Grand Rapids,MI,4,Toledo,OH,03-05-2016,1137,323,7274,8125,76,Domestic,10,2016-04-29,2016-05-03,4,29,851,4 days,4122793,3716002
863,10864,1,1,openzap,30-04-2016,Springfield,IL,1,Skokie,IL,01-05-2016,748,324,892,5621,92,Domestic,1,2016-04-30,2016-05-01,4,30,4729,1 days,4128414,3716894
1374,11375,3,2,Indigoice,30-04-2016,Gary,IN,7,Milwaukee,WI,06-05-2016,961,520,2391,2808,56,International,5,2016-04-30,2016-05-06,4,30,417,6 days,4131222,3719285
1353,11354,2,4,Inzone,30-04-2016,Madison,WI,6,Kalamazoo,MI,03-05-2016,1148,652,7340,5518,92,International,9,2016-04-30,2016-05-03,4,30,-1822,3 days,4136740,3726625
1257,11258,3,6,Newzap,30-04-2016,Indianapolis,IN,1,Northbrook,IL,01-05-2016,1081,383,7503,7945,51,Domestic,2,2016-04-30,2016-05-01,4,30,442,1 days,4144685,3734128
1248,11249,3,4,Daltfax,30-04-2016,Cincinnati,OH,2,Gary,IN,02-05-2016,561,561,6363,4394,82,Domestic,3,2016-04-30,2016-05-02,4,30,-1969,2 days,4149079,3740491
1675,11676,3,1,Rankphase,30-04-2016,Detriot,MI,1,Monon,IN,01-05-2016,454,397,5243,9861,84,Intercom,7,2016-04-30,2016-05-01,4,30,4618,1 days,4158940,3745734
80,10081,1,4,Condintex,01-05-2016,Springfield,IL,5,Skokie,IL,04-05-2016,477,287,5134,2429,66,International,8,2016-05-01,2016-05-04,5,1,-2705,3 days,4161369,3750868
1369,11370,2,5,Zerhouse,01-05-2016,Springfield,IL,1,Skokie,IL,02-05-2016,218,218,6297,6804,87,Intercom,3,2016-05-01,2016-05-02,5,1,507,1 days,4168173,3757165
828,10829,2,8,Tonsanhigh,01-05-2016,Appleton,WI,3,Grand Rapids,MI,04-05-2016,959,638,4747,4849,99,Domestic,2,2016-05-01,2016-05-04,5,1,102,3 days,4173022,3761912
626,10627,2,6,Sanin,01-05-2016,Detriot,MI,3,Monon,IN,04-05-2016,1058,423,5577,5944,93,Domestic,3,2016-05-01,2016-05-04,5,1,367,3 days,4178966,3767489
913,10914,2,3,Dingity,02-05-2016,Detriot,MI,2,Monon,IN,04-05-2016,1001,402,2891,3740,59,Intercom,7,2016-05-02,2016-05-04,5,2,849,2 days,4182706,3770380
1603,11604,2,3,Solostreet,02-05-2016,Elgin,IL,5,Cincinnati,OH,08-05-2016,680,680,3965,4520,56,International,7,2016-05-02,2016-05-08,5,2,555,6 days,4187226,3774345
715,10716,1,5,Plusity,02-05-2016,Detriot,MI,8,Monon,IN,07-05-2016,1152,312,1209,1959,78,International,7,2016-05-02,2016-05-07,5,2,750,5 days,4189185,3775554
47,10048,2,5,xx-bam,02-05-2016,Gary,IN,4,Milwaukee,WI,06-05-2016,609,609,5290,6278,61,Domestic,9,2016-05-02,2016-05-06,5,2,988,4 days,4195463,3780844
515,10516,2,8,Faxzumtrax,02-05-2016,Indianapolis,IN,2,Northbrook,IL,03-05-2016,934,548,1789,2397,93,Domestic,1,2016-05-02,2016-05-03,5,2,608,1 days,4197860,3782633
733,10734,2,5,Y-flex,02-05-2016,Chicago,IL,7,Rockford,IL,06-05-2016,519,427,925,1541,51,International,10,2016-05-02,2016-05-06,5,2,616,4 days,4199401,3783558
1222,11223,3,1,Whitefan,02-05-2016,Madison,WI,2,Kalamazoo,MI,04-05-2016,412,357,3008,7170,58,Intercom,1,2016-05-02,2016-05-04,5,2,4162,2 days,4206571,3786566
288,10289,2,7,Silverfase,03-05-2016,Skokie,IL,5,Chicago,IL,21-03-2016,1147,533,5004,5718,87,International,6,2016-05-03,2016-03-21,5,3,714,-43 days,4212289,3791570
582,10583,1,4,Latcore,03-05-2016,Gary,IN,4,Milwaukee,WI,07-05-2016,524,451,4276,2422,58,Domestic,7,2016-05-03,2016-05-07,5,3,-1854,4 days,4214711,3795846
1555,11556,3,1,Plusla,03-05-2016,Green Bay,WI,3,Joliet,IL,06-05-2016,1011,545,3394,8507,78,Domestic,10,2016-05-03,2016-05-06,5,3,5113,3 days,4223218,3799240
1421,11422,2,6,Joygreen,03-05-2016,Appleton,WI,1,Grand Rapids,MI,04-05-2016,656,656,25,720,95,Intercom,6,2016-05-03,2016-05-04,5,3,695,1 days,4223938,3799265
567,10568,1,8,Zathlane,03-05-2016,Cincinnati,OH,8,Gary,IN,09-05-2016,1175,420,2447,3148,79,International,7,2016-05-03,2016-05-09,5,3,701,6 days,4227086,3801712
519,10520,1,5,Zunzone,03-05-2016,Monon,IN,3,Lansing,MI,06-05-2016,573,571,5382,6119,56,Domestic,5,2016-05-03,2016-05-06,5,3,737,3 days,4233205,3807094
453,10454,1,4,Saokeycane,03-05-2016,Joliet,IL,8,Madison,WI,11-05-2016,552,552,3736,1678,74,International,3,2016-05-03,2016-05-11,5,3,-2058,8 days,4234883,3810830
845,10846,2,6,Silver-line,03-05-2016,Gary,IN,4,Milwaukee,WI,07-05-2016,558,480,3998,4392,80,Domestic,3,2016-05-03,2016-05-07,5,3,394,4 days,4239275,3814828
1469,11470,2,3,Finlux,04-05-2016,Toledo,OH,3,Detriot,MI,07-05-2016,1060,202,4919,5517,71,Domestic,10,2016-05-04,2016-05-07,5,4,598,3 days,4244792,3819747
843,10844,1,6,Saocity,04-05-2016,Northbrook,IL,3,Naperville,IL,07-05-2016,322,322,7741,8195,53,Domestic,9,2016-05-04,2016-05-07,5,4,454,3 days,4252987,3827488
385,10386,1,7,Templax,04-05-2016,Gary,IN,9,Milwaukee,WI,12-05-2016,370,316,575,923,91,International,1,2016-05-04,2016-05-12,5,4,348,8 days,4253910,3828063
1361,11362,2,6,Ontohatron,04-05-2016,Lansing,MI,1,Dayton,OH,05-05-2016,325,256,1095,1773,50,Domestic,7,2016-05-04,2016-05-05,5,4,678,1 days,4255683,3829158
830,10831,2,8,dan-high,04-05-2016,Dayton,OH,4,Elgin,IL,05-05-2016,491,491,1533,1711,71,Domestic,4,2016-05-04,2016-05-05,5,4,178,1 days,4257394,3830691
685,10686,2,7,Trueplus,04-05-2016,Kalamazoo,MI,1,Bangor,MI,05-05-2016,241,241,2503,3118,73,Domestic,1,2016-05-04,2016-05-05,5,4,615,1 days,4260512,3833194
1628,11629,2,1,stripzim,05-05-2016,Grand Rapids,MI,4,Toledo,OH,08-05-2016,628,349,3795,8188,55,Domestic,7,2016-05-05,2016-05-08,5,5,4393,3 days,4268700,3836989
956,10957,2,5,Faseway,05-05-2016,Joliet,IL,1,Madison,WI,06-05-2016,1134,708,7588,8438,64,Domestic,10,2016-05-05,2016-05-06,5,5,850,1 days,4277138,3844577
1427,11428,2,5,Ganzlane,05-05-2016,Elgin,IL,3,Cincinnati,OH,05-05-2016,919,672,8089,8345,61,Domestic,5,2016-05-05,2016-05-05,5,5,256,0 days,4285483,3852666
1356,11357,2,6,tres-tone,06-05-2016,Rockford,IL,3,Green Bay,WI,09-05-2016,1019,711,1358,2174,96,Domestic,7,2016-05-06,2016-05-09,5,6,816,3 days,4287657,3854024
54,10055,1,4,Greentech,06-05-2016,Dayton,OH,3,Elgin,IL,09-05-2016,952,256,7540,5295,74,Domestic,4,2016-05-06,2016-05-09,5,6,-2245,3 days,4292952,3861564
57,10058,1,6,Unoex,06-05-2016,Bangor,MI,4,Davenport,IA,10-05-2016,705,522,3456,3744,51,Domestic,4,2016-05-06,2016-05-10,5,6,288,4 days,4296696,3865020
749,10750,2,7,Lexidom,06-05-2016,Kalamazoo,MI,9,Bangor,MI,12-05-2016,1091,527,2695,3202,68,International,2,2016-05-06,2016-05-12,5,6,507,6 days,4299898,3867715
1165,11166,2,2,Zathlane,06-05-2016,Davenport,IA,2,Appleton,WI,08-05-2016,908,767,512,1280,82,Domestic,3,2016-05-06,2016-05-08,5,6,768,2 days,4301178,3868227
556,10557,1,5,Ittam,06-05-2016,Indianapolis,IN,2,Northbrook,IL,07-05-2016,953,507,1373,1509,67,Domestic,4,2016-05-06,2016-05-07,5,6,136,1 days,4302687,3869600
1108,11109,2,3,Freebam,06-05-2016,Green Bay,WI,4,Joliet,IL,10-05-2016,835,627,74,364,71,Domestic,6,2016-05-06,2016-05-10,5,6,290,4 days,4303051,3869674
888,10889,2,5,Silverfase,06-05-2016,Northbrook,IL,10,Naperville,IL,16-05-2016,1155,612,5656,6194,100,International,1,2016-05-06,2016-05-16,5,6,538,10 days,4309245,3875330
718,10719,1,7,Tantax,06-05-2016,Monon,IN,3,Lansing,MI,09-05-2016,721,541,2636,3408,82,Domestic,10,2016-05-06,2016-05-09,5,6,772,3 days,4312653,3877966
744,10745,2,6,Geoit,06-05-2016,Dayton,OH,8,Elgin,IL,14-05-2016,1138,356,1931,2199,78,International,4,2016-05-06,2016-05-14,5,6,268,8 days,4314852,3879897
321,10322,1,6,Whitefan,06-05-2016,Madison,WI,10,Kalamazoo,MI,16-05-2016,743,228,5263,5689,65,International,6,2016-05-06,2016-05-16,5,6,426,10 days,4320541,3885160
773,10774,1,8,Zotfan,07-05-2016,Grand Rapids,MI,2,Toledo,OH,09-05-2016,475,475,3291,3491,65,Domestic,8,2016-05-07,2016-05-09,5,7,200,2 days,4324032,3888451
753,10754,2,6,Fixace,07-05-2016,Indianapolis,IN,4,Northbrook,IL,11-05-2016,533,429,5951,6803,73,Domestic,7,2016-05-07,2016-05-11,5,7,852,4 days,4330835,3894402
78,10079,1,5,Gravetech,07-05-2016,Grand Rapids,MI,1,Toledo,OH,08-05-2016,469,264,6183,6330,75,Domestic,9,2016-05-07,2016-05-08,5,7,147,1 days,4337165,3900585
993,10994,3,5,Constreet,07-05-2016,Chicago,IL,4,Rockford,IL,11-05-2016,482,482,4716,5015,71,Domestic,7,2016-05-07,2016-05-11,5,7,299,4 days,4342180,3905301
58,10059,2,7,Zoodrill,07-05-2016,Elgin,IL,2,Cincinnati,OH,08-05-2016,552,552,3790,4454,96,Domestic,6,2016-05-07,2016-05-08,5,7,664,1 days,4346634,3909091
1644,11645,2,1,Geoit,07-05-2016,Dayton,OH,1,Elgin,IL,08-05-2016,1167,627,7258,11700,82,Domestic,9,2016-05-07,2016-05-08,5,7,4442,1 days,4358334,3916349
571,10572,1,6,Viacane,07-05-2016,Bangor,MI,1,Davenport,IA,08-05-2016,806,326,161,736,72,Domestic,4,2016-05-07,2016-05-08,5,7,575,1 days,4359070,3916510
799,10800,1,4,hexzim,08-05-2016,Northbrook,IL,7,Naperville,IL,21-03-2016,1145,238,6510,4823,57,International,1,2016-05-08,2016-03-21,5,8,-1687,-48 days,4363893,3923020
1070,11071,3,6,Medcan,08-05-2016,Toledo,OH,5,Detriot,MI,21-03-2016,654,654,7390,8186,83,International,2,2016-05-08,2016-03-21,5,8,796,-48 days,4372079,3930410
1700,11701,3,2,Striplane,08-05-2016,Naperville,IL,4,Indianapolis,IN,12-05-2016,505,505,2461,2581,90,Domestic,8,2016-05-08,2016-05-12,5,8,120,4 days,4374660,3932871
1582,11583,2,3,bluecorporation,08-05-2016,Bangor,MI,1,Davenport,IA,09-05-2016,947,643,7880,8812,53,Domestic,8,2016-05-08,2016-05-09,5,8,932,1 days,4383472,3940751
65,10066,2,7,Blueit,08-05-2016,Detriot,MI,6,Monon,IN,13-05-2016,970,414,6036,6301,55,International,1,2016-05-08,2016-05-13,5,8,265,5 days,4389773,3946787
1012,11013,3,1,Laex,08-05-2016,Grand Rapids,MI,4,Toledo,OH,10-05-2016,338,297,4967,8956,54,Domestic,3,2016-05-08,2016-05-10,5,8,3989,2 days,4398729,3951754
878,10879,2,3,Goldentechi,08-05-2016,Lansing,MI,5,Dayton,OH,10-05-2016,726,726,5069,5859,50,International,3,2016-05-08,2016-05-10,5,8,790,2 days,4404588,3956823
118,10119,2,7,Matsanice,08-05-2016,Bangor,MI,10,Davenport,IA,15-05-2016,411,290,6017,6119,100,International,1,2016-05-08,2016-05-15,5,8,102,7 days,4410707,3962840
275,10276,1,8,tinron,08-05-2016,Northbrook,IL,3,Naperville,IL,11-05-2016,619,468,6931,7513,75,Domestic,4,2016-05-08,2016-05-11,5,8,582,3 days,4418220,3969771
1177,11178,3,2,Iselectrics,09-05-2016,Green Bay,WI,2,Joliet,IL,11-05-2016,489,489,956,1269,59,Domestic,5,2016-05-09,2016-05-11,5,9,313,2 days,4419489,3970727
1272,11273,3,5,Xx-canex,09-05-2016,Bangor,MI,8,Davenport,IA,17-05-2016,482,481,742,1679,54,International,10,2016-05-09,2016-05-17,5,9,937,8 days,4421168,3971469
569,10570,1,8,Finlux,09-05-2016,Toledo,OH,1,Detriot,MI,10-05-2016,1020,643,2354,3256,62,Domestic,6,2016-05-09,2016-05-10,5,9,902,1 days,4424424,3973823
1495,11496,2,1,Subdrill,09-05-2016,Skokie,IL,8,Chicago,IL,21-03-2016,543,229,6000,10643,89,International,6,2016-05-09,2016-03-21,5,9,4643,-49 days,4435067,3979823
1770,11771,2,2,Canace,09-05-2016,Appleton,WI,6,Grand Rapids,MI,12-05-2016,317,317,7111,7260,51,International,9,2016-05-09,2016-05-12,5,9,149,3 days,4442327,3986934
335,10336,1,6,Zuntexon,09-05-2016,Springfield,IL,1,Skokie,IL,10-05-2016,320,320,3648,4591,98,Domestic,4,2016-05-09,2016-05-10,5,9,943,1 days,4446918,3990582
1602,11603,3,6,Canetechnology,09-05-2016,Lansing,MI,7,Dayton,OH,19-05-2016,1119,269,2820,3269,96,International,7,2016-05-09,2016-05-19,5,9,449,10 days,4450187,3993402
193,10194,1,7,Isdexon,09-05-2016,Madison,WI,4,Kalamazoo,MI,13-05-2016,1116,299,7865,8111,96,Domestic,9,2016-05-09,2016-05-13,5,9,246,4 days,4458298,4001267
1113,11114,2,2,Statway,09-05-2016,Dayton,OH,3,Elgin,IL,10-05-2016,870,263,3421,3958,86,Domestic,7,2016-05-09,2016-05-10,5,9,537,1 days,4462256,4004688
347,10348,1,8,Anmedia,10-05-2016,Appleton,WI,8,Grand Rapids,MI,17-05-2016,1117,743,777,1397,53,International,7,2016-05-10,2016-05-17,5,10,620,7 days,4463653,4005465
1589,11590,3,3,Zummatexon,10-05-2016,Chicago,IL,4,Rockford,IL,14-05-2016,870,210,4122,4229,73,Domestic,8,2016-05-10,2016-05-14,5,10,107,4 days,4467882,4009587
205,10206,1,8,Plexlamway,10-05-2016,Grand Rapids,MI,4,Toledo,OH,13-05-2016,834,580,954,1633,68,Domestic,6,2016-05-10,2016-05-13,5,10,679,3 days,4469515,4010541
285,10286,2,5,bamity,10-05-2016,Lansing,MI,8,Dayton,OH,18-05-2016,426,357,3782,3882,55,International,6,2016-05-10,2016-05-18,5,10,100,8 days,4473397,4014323
464,10465,2,5,Dongtinlux,10-05-2016,Elgin,IL,2,Cincinnati,OH,12-05-2016,383,383,5734,6388,74,Domestic,9,2016-05-10,2016-05-12,5,10,654,2 days,4479785,4020057
679,10680,2,8,Saozoomtex,10-05-2016,Cincinnati,OH,5,Gary,IN,12-05-2016,468,468,2959,3114,88,International,2,2016-05-10,2016-05-12,5,10,155,2 days,4482899,4023016
1702,11703,2,3,re-can,10-05-2016,Appleton,WI,1,Grand Rapids,MI,11-05-2016,1062,514,6242,6600,62,Domestic,8,2016-05-10,2016-05-11,5,10,358,1 days,4489499,4029258
1403,11404,2,1,Plexlamway,10-05-2016,Dayton,OH,5,Elgin,IL,15-05-2016,415,367,7117,11395,70,International,1,2016-05-10,2016-05-15,5,10,4278,5 days,4500894,4036375
644,10645,2,5,Goldenbam,11-05-2016,Milwaukee,WI,2,Springfield,IL,13-05-2016,295,295,646,1289,83,Domestic,1,2016-05-11,2016-05-13,5,11,643,2 days,4502183,4037021
376,10377,2,4,Duo-fase,11-05-2016,Kalamazoo,MI,7,Bangor,MI,18-05-2016,297,297,4223,2349,68,International,8,2016-05-11,2016-05-18,5,11,-1874,7 days,4504532,4041244
233,10234,2,5,dan-high,11-05-2016,Joliet,IL,8,Madison,WI,19-05-2016,975,279,976,1088,77,International,7,2016-05-11,2016-05-19,5,11,112,8 days,4505620,4042220
513,10514,1,4,Sonbam,11-05-2016,Springfield,IL,7,Skokie,IL,16-05-2016,451,451,6931,4961,50,International,6,2016-05-11,2016-05-16,5,11,-1970,5 days,4510581,4049151
1651,11652,2,4,Keystreet,11-05-2016,Milwaukee,WI,4,Springfield,IL,15-05-2016,708,338,6542,4367,53,Domestic,7,2016-05-11,2016-05-15,5,11,-2175,4 days,4514948,4055693
1730,11731,2,2,Danfan,11-05-2016,Elgin,IL,2,Cincinnati,OH,13-05-2016,852,426,5042,5912,99,Domestic,1,2016-05-11,2016-05-13,5,11,870,2 days,4520860,4060735
798,10799,1,7,Opebase,11-05-2016,Indianapolis,IN,8,Northbrook,IL,19-05-2016,246,246,5351,5695,81,International,2,2016-05-11,2016-05-19,5,11,344,8 days,4526555,4066086
985,10986,3,2,Medialax,12-05-2016,Toledo,OH,3,Detriot,MI,15-05-2016,224,224,2937,3724,97,Domestic,8,2016-05-12,2016-05-15,5,12,787,3 days,4530279,4069023
114,10115,2,6,Donglax,12-05-2016,Cincinnati,OH,1,Gary,IN,13-05-2016,1135,227,4738,5382,61,Domestic,10,2016-05-12,2016-05-13,5,12,644,1 days,4535661,4073761
343,10344,2,8,silfase,12-05-2016,Madison,WI,2,Kalamazoo,MI,14-05-2016,1034,215,1551,2330,52,Intercom,4,2016-05-12,2016-05-14,5,12,779,2 days,4537991,4075312
449,10450,2,8,Zuntone,12-05-2016,Chicago,IL,4,Rockford,IL,16-05-2016,201,201,4839,5146,95,Domestic,1,2016-05-12,2016-05-16,5,12,307,4 days,4543137,4080151
397,10398,1,5,Constreet,12-05-2016,Bangor,MI,10,Davenport,IA,22-05-2016,366,366,6401,6573,72,International,5,2016-05-12,2016-05-22,5,12,172,10 days,4549710,4086552
1136,11137,3,2,Konknix,12-05-2016,Dayton,OH,3,Elgin,IL,15-05-2016,209,209,257,1232,75,Domestic,3,2016-05-12,2016-05-15,5,12,975,3 days,4550942,4086809
1337,11338,2,1,Ozeris,12-05-2016,Lansing,MI,1,Dayton,OH,13-05-2016,387,223,5607,9738,56,Domestic,2,2016-05-12,2016-05-13,5,12,4131,1 days,4560680,4092416
1686,11687,3,2,Golddexon,13-05-2016,Skokie,IL,8,Chicago,IL,21-05-2016,606,588,5091,5706,88,International,9,2016-05-13,2016-05-21,5,13,615,8 days,4566386,4097507
1033,11034,2,2,Warelane,13-05-2016,Skokie,IL,9,Chicago,IL,22-05-2016,216,216,2373,3311,59,International,9,2016-05-13,2016-05-22,5,13,938,9 days,4569697,4099880
929,10930,3,3,Sanin,13-05-2016,Kalamazoo,MI,6,Bangor,MI,19-05-2016,478,478,4082,4613,65,International,1,2016-05-13,2016-05-19,5,13,531,6 days,4574310,4103962
1690,11691,2,6,white-high,13-05-2016,Milwaukee,WI,10,Springfield,IL,21-03-2016,613,312,7805,8194,86,International,1,2016-05-13,2016-03-21,5,13,389,-53 days,4582504,4111767
1710,11711,2,6,Linezatlam,13-05-2016,Kalamazoo,MI,2,Bangor,MI,15-05-2016,852,314,4757,5046,93,Intercom,2,2016-05-13,2016-05-15,5,13,289,2 days,4587550,4116524
433,10434,1,7,Dingquokix,13-05-2016,Monon,IN,7,Lansing,MI,20-05-2016,1138,221,7676,8148,92,International,5,2016-05-13,2016-05-20,5,13,472,7 days,4595698,4124200
6,10007,2,4,Howtaxon,14-05-2016,Gary,IN,4,Milwaukee,WI,18-05-2016,1041,328,7603,5516,97,Domestic,4,2016-05-14,2016-05-18,5,14,-2087,4 days,4601214,4131803
1488,11489,3,2,Silverfase,14-05-2016,Rockford,IL,4,Green Bay,WI,18-05-2016,991,684,1194,1760,57,Domestic,1,2016-05-14,2016-05-18,5,14,566,4 days,4602974,4132997
1004,11005,3,1,Jaylane,14-05-2016,Dayton,OH,3,Elgin,IL,14-05-2016,938,515,3307,8375,74,Domestic,8,2016-05-14,2016-05-14,5,14,5068,0 days,4611349,4136304
1581,11582,3,4,Zentrax,14-05-2016,Lansing,MI,1,Dayton,OH,15-05-2016,398,376,4753,3382,58,Domestic,9,2016-05-14,2016-05-15,5,14,-1371,1 days,4614731,4141057
536,10537,1,6,Y-strip,14-05-2016,Chicago,IL,3,Rockford,IL,17-05-2016,861,429,1555,2279,70,Domestic,6,2016-05-14,2016-05-17,5,14,724,3 days,4617010,4142612
1773,11774,2,3,Tantechi,14-05-2016,Toledo,OH,1,Detriot,MI,15-05-2016,684,455,6097,6224,59,Domestic,4,2016-05-14,2016-05-15,5,14,127,1 days,4623234,4148709
944,10945,3,5,Goldenbam,14-05-2016,Toledo,OH,9,Detriot,MI,23-05-2016,1149,663,5948,6077,53,International,10,2016-05-14,2016-05-23,5,14,129,9 days,4629311,4154657
472,10473,2,4,Yearcorporation,14-05-2016,Indianapolis,IN,6,Northbrook,IL,20-05-2016,608,517,3658,2453,86,International,6,2016-05-14,2016-05-20,5,14,-1205,6 days,4631764,4158315
1391,11392,2,2,Faseelectronics,14-05-2016,Chicago,IL,10,Rockford,IL,23-05-2016,786,234,3138,3873,74,International,5,2016-05-14,2016-05-23,5,14,735,9 days,4635637,4161453
246,10247,1,6,Silver-line,15-05-2016,Davenport,IA,2,Appleton,WI,17-05-2016,730,229,3488,4168,64,Domestic,10,2016-05-15,2016-05-17,5,15,680,2 days,4639805,4164941
1406,11407,2,3,Scothouse,15-05-2016,Bangor,MI,2,Davenport,IA,17-05-2016,535,525,3179,4070,56,Domestic,5,2016-05-15,2016-05-17,5,15,891,2 days,4643875,4168120
1438,11439,2,1,Konknix,15-05-2016,Joliet,IL,9,Madison,WI,24-05-2016,932,662,1343,5313,71,International,10,2016-05-15,2016-05-24,5,15,3970,9 days,4649188,4169463
919,10920,3,2,Cannamcon,15-05-2016,Naperville,IL,2,Indianapolis,IN,16-05-2016,980,736,4976,5446,96,Domestic,8,2016-05-15,2016-05-16,5,15,470,1 days,4654634,4174439
93,10094,1,5,Templax,15-05-2016,Cincinnati,OH,8,Gary,IN,23-05-2016,610,600,1255,1647,50,International,5,2016-05-15,2016-05-23,5,15,392,8 days,4656281,4175694
938,10939,3,1,Zuntexon,16-05-2016,Madison,WI,4,Kalamazoo,MI,20-05-2016,281,281,6303,10865,74,Domestic,1,2016-05-16,2016-05-20,5,16,4562,4 days,4667146,4181997
641,10642,2,8,Mathing,16-05-2016,Kalamazoo,MI,8,Bangor,MI,21-05-2016,868,235,7835,8248,93,International,2,2016-05-16,2016-05-21,5,16,413,5 days,4675394,4189832
1322,11323,2,4,Goodquoing,16-05-2016,Milwaukee,WI,1,Springfield,IL,17-05-2016,847,308,6283,4679,76,Domestic,5,2016-05-16,2016-05-17,5,16,-1604,1 days,4680073,4196115
1144,11145,2,6,Condexon,16-05-2016,Milwaukee,WI,7,Springfield,IL,21-03-2016,324,324,1173,1301,99,International,7,2016-05-16,2016-03-21,5,16,128,-56 days,4681374,4197288
60,10061,2,5,Daltfax,16-05-2016,Davenport,IA,5,Appleton,WI,21-05-2016,377,377,1306,1702,94,International,2,2016-05-16,2016-05-21,5,16,396,5 days,4683076,4198594
1669,11670,3,5,Indigoice,16-05-2016,Davenport,IA,2,Appleton,WI,18-05-2016,601,335,6660,7068,50,Domestic,4,2016-05-16,2016-05-18,5,16,408,2 days,4690144,4205254
1719,11720,3,4,Namelectronics,16-05-2016,Monon,IN,1,Lansing,MI,17-05-2016,970,578,6611,4713,81,Domestic,7,2016-05-16,2016-05-17,5,16,-1898,1 days,4694857,4211865
1609,11610,3,2,Matsanice,16-05-2016,Chicago,IL,5,Rockford,IL,20-05-2016,923,339,7915,8213,92,International,1,2016-05-16,2016-05-20,5,16,298,4 days,4703070,4219780
182,10183,2,6,Toncode,16-05-2016,Skokie,IL,8,Chicago,IL,21-03-2016,413,291,2270,2520,57,International,9,2016-05-16,2016-03-21,5,16,250,-56 days,4705590,4222050
59,10060,2,5,Anmedia,16-05-2016,Kalamazoo,MI,8,Bangor,MI,24-05-2016,1044,564,424,958,50,International,6,2016-05-16,2016-05-24,5,16,534,8 days,4706548,4222474
1169,11170,2,6,Viacane,16-05-2016,Chicago,IL,8,Rockford,IL,22-05-2016,358,358,8076,8719,52,International,6,2016-05-16,2016-05-22,5,16,643,6 days,4715267,4230550
329,10330,1,8,Saohow,16-05-2016,Lansing,MI,10,Dayton,OH,23-05-2016,718,464,543,1214,51,International,4,2016-05-16,2016-05-23,5,16,671,7 days,4716481,4231093
976,10977,3,1,Funlax,16-05-2016,Joliet,IL,4,Madison,WI,17-05-2016,397,397,7168,11280,90,Domestic,5,2016-05-16,2016-05-17,5,16,4112,1 days,4727761,4238261
1774,11775,3,1,Goldentechi,17-05-2016,Lansing,MI,2,Dayton,OH,19-05-2016,394,319,3610,8891,66,Domestic,3,2016-05-17,2016-05-19,5,17,5281,2 days,4736652,4241871
1181,11182,2,4,Latcore,17-05-2016,Cincinnati,OH,10,Gary,IN,27-05-2016,488,488,4117,1938,75,International,7,2016-05-17,2016-05-27,5,17,-2179,10 days,4738590,4245988
687,10688,2,4,roundphase,17-05-2016,Grand Rapids,MI,4,Toledo,OH,20-05-2016,953,462,2888,291,83,Domestic,3,2016-05-17,2016-05-20,5,17,-2597,3 days,4738881,4248876
115,10116,2,4,Jaylane,17-05-2016,Dayton,OH,2,Elgin,IL,19-05-2016,1085,635,8143,5905,77,Domestic,8,2016-05-17,2016-05-19,5,17,-2238,2 days,4744786,4257019
658,10659,1,4,Faseway,17-05-2016,Dayton,OH,2,Elgin,IL,19-05-2016,851,733,2807,537,82,Domestic,5,2016-05-17,2016-05-19,5,17,-2270,2 days,4745323,4259826
1047,11048,2,6,zummatax,17-05-2016,Cincinnati,OH,2,Gary,IN,19-05-2016,621,367,6739,7231,53,Domestic,6,2016-05-17,2016-05-19,5,17,492,2 days,4752554,4266565
426,10427,1,6,Fasetech,17-05-2016,Springfield,IL,3,Skokie,IL,20-05-2016,1019,210,59,296,97,Domestic,5,2016-05-17,2016-05-20,5,17,237,3 days,4752850,4266624
1010,11011,2,6,Plusity,17-05-2016,Kalamazoo,MI,2,Bangor,MI,19-05-2016,781,535,828,1627,77,Domestic,4,2016-05-17,2016-05-19,5,17,799,2 days,4754477,4267452
1583,11584,3,1,Fin-cone,17-05-2016,Elgin,IL,1,Cincinnati,OH,17-05-2016,941,263,4797,10512,70,Domestic,9,2016-05-17,2016-05-17,5,17,5715,0 days,4764989,4272249
1237,11238,3,5,Howplanet,18-05-2016,Chicago,IL,9,Rockford,IL,27-05-2016,357,357,2266,2764,81,International,10,2016-05-18,2016-05-27,5,18,498,9 days,4767753,4274515
608,10609,1,8,scotquote,18-05-2016,Madison,WI,3,Kalamazoo,MI,21-05-2016,1046,708,2864,3242,75,Domestic,3,2016-05-18,2016-05-21,5,18,378,3 days,4770995,4277379
1069,11070,3,3,Zotfan,18-05-2016,Dayton,OH,8,Elgin,IL,26-05-2016,499,366,7168,7690,59,International,7,2016-05-18,2016-05-26,5,18,522,8 days,4778685,4284547
1204,11205,2,2,Villacom,18-05-2016,Dayton,OH,3,Elgin,IL,21-05-2016,275,256,7264,8065,63,Domestic,9,2016-05-18,2016-05-21,5,18,801,3 days,4786750,4291811
1548,11549,3,2,Zoodrill,19-05-2016,Indianapolis,IN,2,Northbrook,IL,20-05-2016,489,489,7832,8393,78,Domestic,6,2016-05-19,2016-05-20,5,19,561,1 days,4795143,4299643
413,10414,1,6,Ronplanet,19-05-2016,Naperville,IL,2,Indianapolis,IN,20-05-2016,404,404,7234,8108,72,Domestic,5,2016-05-19,2016-05-20,5,19,874,1 days,4803251,4306877
784,10785,2,6,Funlatlex,19-05-2016,Naperville,IL,3,Indianapolis,IN,22-05-2016,938,244,4497,4963,96,Domestic,5,2016-05-19,2016-05-22,5,19,466,3 days,4808214,4311374
1191,11192,2,3,san-plex,19-05-2016,Milwaukee,WI,2,Springfield,IL,21-05-2016,470,470,8760,8948,93,Domestic,4,2016-05-19,2016-05-21,5,19,188,2 days,4817162,4320134
12,10013,2,6,Conzumzap,19-05-2016,Appleton,WI,1,Grand Rapids,MI,20-05-2016,486,451,4896,5272,69,Intercom,4,2016-05-19,2016-05-20,5,19,376,1 days,4822434,4325030
270,10271,2,8,Hayholding,19-05-2016,Grand Rapids,MI,5,Toledo,OH,24-05-2016,628,220,2892,3019,80,International,4,2016-05-19,2016-05-24,5,19,127,5 days,4825453,4327922
748,10749,1,6,Labdox,19-05-2016,Skokie,IL,3,Chicago,IL,22-05-2016,1171,798,2516,3077,77,Domestic,7,2016-05-19,2016-05-22,5,19,561,3 days,4828530,4330438
1737,11738,3,2,Zimex,19-05-2016,Indianapolis,IN,3,Northbrook,IL,22-05-2016,960,415,5229,5378,89,Domestic,8,2016-05-19,2016-05-22,5,19,149,3 days,4833908,4335667
1275,11276,3,6,Duo-fase,20-05-2016,Kalamazoo,MI,1,Bangor,MI,21-05-2016,460,460,7937,8704,50,Intercom,6,2016-05-20,2016-05-21,5,20,767,1 days,4842612,4343604
1718,11719,2,3,Joygreen,20-05-2016,Detriot,MI,3,Monon,IN,23-05-2016,240,240,2243,2745,84,Domestic,9,2016-05-20,2016-05-23,5,20,502,3 days,4845357,4345847
1000,11001,2,3,Zotcare,20-05-2016,Green Bay,WI,2,Joliet,IL,22-05-2016,1003,668,107,345,75,Domestic,3,2016-05-20,2016-05-22,5,20,238,2 days,4845702,4345954
682,10683,2,8,bluecorporation,20-05-2016,Bangor,MI,3,Davenport,IA,23-05-2016,1123,415,2709,3521,74,Domestic,4,2016-05-20,2016-05-23,5,20,812,3 days,4849223,4348663
3,10004,1,5,Viatom,20-05-2016,Indianapolis,IN,1,Northbrook,IL,21-05-2016,450,362,6807,7571,77,Domestic,4,2016-05-20,2016-05-21,5,20,764,1 days,4856794,4355470
1471,11472,2,3,Viacane,20-05-2016,Bangor,MI,1,Davenport,IA,21-05-2016,928,638,4369,5267,87,Domestic,10,2016-05-20,2016-05-21,5,20,898,1 days,4862061,4359839
885,10886,2,4,Plustax,20-05-2016,Milwaukee,WI,1,Springfield,IL,21-05-2016,669,572,8067,6342,50,Domestic,6,2016-05-20,2016-05-21,5,20,-1725,1 days,4868403,4367906
209,10210,2,7,Striplane,20-05-2016,Indianapolis,IN,3,Northbrook,IL,23-05-2016,397,296,3040,3402,77,Domestic,10,2016-05-20,2016-05-23,5,20,362,3 days,4871805,4370946
598,10599,1,8,Trio-dax,20-05-2016,Grand Rapids,MI,10,Toledo,OH,30-05-2016,985,270,4635,4922,56,International,1,2016-05-20,2016-05-30,5,20,287,10 days,4876727,4375581
377,10378,2,6,Saozoomtex,20-05-2016,Davenport,IA,8,Appleton,WI,28-05-2016,222,222,6687,7409,76,International,10,2016-05-20,2016-05-28,5,20,722,8 days,4884136,4382268
465,10466,2,4,geohigh,20-05-2016,Skokie,IL,1,Chicago,IL,21-05-2016,683,486,3812,1533,51,Domestic,1,2016-05-20,2016-05-21,5,20,-2279,1 days,4885669,4386080
401,10402,1,4,Zimjiit,21-05-2016,Davenport,IA,3,Appleton,WI,24-05-2016,1165,729,2273,722,89,Domestic,2,2016-05-21,2016-05-24,5,21,-1551,3 days,4886391,4388353
1,10002,2,7,Plustax,21-05-2016,Milwaukee,WI,2,Springfield,IL,23-05-2016,317,317,646,1199,62,Domestic,8,2016-05-21,2016-05-23,5,21,553,2 days,4887590,4388999
466,10467,1,4,Mediaware,21-05-2016,Kalamazoo,MI,2,Bangor,MI,23-05-2016,1026,568,4716,3001,87,Domestic,1,2016-05-21,2016-05-23,5,21,-1715,2 days,4890591,4393715
1468,11469,2,3,Zathlane,21-05-2016,Cincinnati,OH,1,Gary,IN,22-05-2016,401,261,7421,8082,97,Domestic,2,2016-05-21,2016-05-22,5,21,661,1 days,4898673,4401136
643,10644,1,5,Greentech,21-05-2016,Grand Rapids,MI,4,Toledo,OH,24-05-2016,993,227,8519,8748,57,Domestic,4,2016-05-21,2016-05-24,5,21,229,3 days,4907421,4409655
1597,11598,2,1,Dripvivadex,21-05-2016,Rockford,IL,4,Green Bay,WI,25-05-2016,943,525,2326,6700,97,Domestic,4,2016-05-21,2016-05-25,5,21,4374,4 days,4914121,4411981
191,10192,1,8,Anzammedia,21-05-2016,Detriot,MI,2,Monon,IN,23-05-2016,1014,367,3668,3911,92,Domestic,4,2016-05-21,2016-05-23,5,21,243,2 days,4918032,4415649
987,10988,2,6,Zummatexon,21-05-2016,Bangor,MI,6,Davenport,IA,24-05-2016,271,271,1905,2341,66,International,7,2016-05-21,2016-05-24,5,21,436,3 days,4920373,4417554
125,10126,2,7,Solohex,22-05-2016,Springfield,IL,4,Skokie,IL,26-05-2016,701,290,1970,2241,57,Domestic,1,2016-05-22,2016-05-26,5,22,271,4 days,4922614,4419524
336,10337,2,6,Howplanet,22-05-2016,Chicago,IL,4,Rockford,IL,26-05-2016,1013,562,6912,7754,56,Domestic,7,2016-05-22,2016-05-26,5,22,842,4 days,4930368,4426436
129,10130,2,7,Joyancom,22-05-2016,Detriot,MI,7,Monon,IN,29-05-2016,1114,294,8044,8210,68,International,2,2016-05-22,2016-05-29,5,22,166,7 days,4938578,4434480
694,10695,2,7,Donplanet,22-05-2016,Gary,IN,4,Milwaukee,WI,26-05-2016,1094,208,7449,7606,96,Domestic,4,2016-05-22,2016-05-26,5,22,157,4 days,4946184,4441929
891,10892,2,6,xx-way,22-05-2016,Joliet,IL,8,Madison,WI,30-05-2016,1148,701,1379,1587,98,International,5,2016-05-22,2016-05-30,5,22,208,8 days,4947771,4443308
1146,11147,3,2,betaity,23-05-2016,Indianapolis,IN,4,Northbrook,IL,27-05-2016,660,464,4320,4745,92,Domestic,7,2016-05-23,2016-05-27,5,23,425,4 days,4952516,4447628
431,10432,1,6,Treedrill,23-05-2016,Gary,IN,1,Milwaukee,WI,24-05-2016,1056,738,2673,2937,66,Domestic,4,2016-05-23,2016-05-24,5,23,264,1 days,4955453,4450301
1366,11367,2,4,Goldenlex,23-05-2016,Davenport,IA,5,Appleton,WI,28-05-2016,535,480,5136,3635,93,International,9,2016-05-23,2016-05-28,5,23,-1501,5 days,4959088,4455437
338,10339,1,5,Sanlab,23-05-2016,Northbrook,IL,8,Naperville,IL,31-05-2016,1002,778,324,755,93,International,1,2016-05-23,2016-05-31,5,23,431,8 days,4959843,4455761
1341,11342,3,3,Faseron,23-05-2016,Kalamazoo,MI,3,Bangor,MI,26-05-2016,702,702,6159,6277,69,Domestic,1,2016-05-23,2016-05-26,5,23,118,3 days,4966120,4461920
936,10937,3,2,Zaamhouse,23-05-2016,Joliet,IL,2,Madison,WI,24-05-2016,993,449,7016,7614,52,Domestic,5,2016-05-23,2016-05-24,5,23,598,1 days,4973734,4468936
111,10112,1,4,Solostreet,24-05-2016,Naperville,IL,7,Indianapolis,IN,31-05-2016,322,322,2472,612,63,International,7,2016-05-24,2016-05-31,5,24,-1860,7 days,4974346,4471408
1411,11412,3,2,ganz-is,24-05-2016,Milwaukee,WI,2,Springfield,IL,26-05-2016,472,349,6860,7495,82,Domestic,8,2016-05-24,2016-05-26,5,24,635,2 days,4981841,4478268
17,10018,1,6,Ganjazone,24-05-2016,Elgin,IL,2,Cincinnati,OH,25-05-2016,220,220,5772,6491,83,Domestic,9,2016-05-24,2016-05-25,5,24,719,1 days,4988332,4484040
1659,11660,2,2,Dongtinlux,24-05-2016,Naperville,IL,4,Indianapolis,IN,28-05-2016,917,237,7339,7822,80,Domestic,6,2016-05-24,2016-05-28,5,24,483,4 days,4996154,4491379
1297,11298,3,3,Zimjiit,24-05-2016,Davenport,IA,8,Appleton,WI,31-05-2016,457,457,1623,1996,56,International,7,2016-05-24,2016-05-31,5,24,373,7 days,4998150,4493002
990,10991,2,4,Plextechi,24-05-2016,Kalamazoo,MI,1,Bangor,MI,25-05-2016,997,608,3534,1836,99,Domestic,5,2016-05-24,2016-05-25,5,24,-1698,1 days,4999986,4496536
1768,11769,2,5,Gogokeying,24-05-2016,Naperville,IL,1,Indianapolis,IN,25-05-2016,558,453,6941,7297,83,Domestic,7,2016-05-24,2016-05-25,5,24,356,1 days,5007283,4503477
1389,11390,3,3,Tripple-fax,25-05-2016,Grand Rapids,MI,1,Toledo,OH,26-05-2016,1056,700,6937,7759,86,Domestic,10,2016-05-25,2016-05-26,5,25,822,1 days,5015042,4510414
1489,11490,2,2,O-job,25-05-2016,Appleton,WI,2,Grand Rapids,MI,27-05-2016,518,426,324,1324,76,Domestic,2,2016-05-25,2016-05-27,5,25,1000,2 days,5016366,4510738
1059,11060,3,5,Dongtinlux,25-05-2016,Indianapolis,IN,2,Northbrook,IL,26-05-2016,920,543,281,800,93,Domestic,6,2016-05-25,2016-05-26,5,25,519,1 days,5017166,4511019
1273,11274,2,6,Itdom,25-05-2016,Elgin,IL,8,Cincinnati,OH,02-06-2016,484,399,3255,3825,80,International,9,2016-05-25,2016-06-02,5,25,570,8 days,5020991,4514274
1390,11391,2,4,Qvofix,25-05-2016,Milwaukee,WI,1,Springfield,IL,26-05-2016,960,523,5073,3779,96,Domestic,10,2016-05-25,2016-05-26,5,25,-1294,1 days,5024770,4519347
1176,11177,3,4,Goldentechi,25-05-2016,Madison,WI,3,Kalamazoo,MI,28-05-2016,708,481,4671,3175,85,Domestic,7,2016-05-25,2016-05-28,5,25,-1496,3 days,5027945,4524018
1082,11083,2,4,Anzammedia,25-05-2016,Detriot,MI,2,Monon,IN,27-05-2016,640,640,6536,4539,63,Domestic,1,2016-05-25,2016-05-27,5,25,-1997,2 days,5032484,4530554
1592,11593,2,2,Donplanet,25-05-2016,Gary,IN,5,Milwaukee,WI,27-05-2016,808,217,820,1713,69,International,1,2016-05-25,2016-05-27,5,25,893,2 days,5034197,4531374
1681,11682,3,6,Anzammedia,26-05-2016,Appleton,WI,1,Grand Rapids,MI,27-05-2016,545,545,6433,6713,51,Domestic,9,2016-05-26,2016-05-27,5,26,280,1 days,5040910,4537807
1626,11627,2,5,Kantone,26-05-2016,Kalamazoo,MI,5,Bangor,MI,29-05-2016,1146,673,3109,3255,58,International,10,2016-05-26,2016-05-29,5,26,146,3 days,5044165,4540916
926,10927,2,3,Strongdax,26-05-2016,Bangor,MI,2,Davenport,IA,28-05-2016,279,279,2681,3320,73,Domestic,9,2016-05-26,2016-05-28,5,26,639,2 days,5047485,4543597
1627,11628,2,2,Treedrill,26-05-2016,Davenport,IA,9,Appleton,WI,03-06-2016,779,764,3884,4146,69,International,6,2016-05-26,2016-06-03,5,26,262,8 days,5051631,4547481
530,10531,1,7,Streetlam,26-05-2016,Skokie,IL,3,Chicago,IL,29-05-2016,531,531,8066,8994,58,Domestic,10,2016-05-26,2016-05-29,5,26,928,3 days,5060625,4555547
1027,11028,3,6,Treedrill,26-05-2016,Cincinnati,OH,3,Gary,IN,29-05-2016,1160,792,7179,7285,89,Domestic,2,2016-05-26,2016-05-29,5,26,106,3 days,5067910,4562726
1542,11543,3,3,Sanlab,26-05-2016,Skokie,IL,3,Chicago,IL,29-05-2016,278,278,3482,3725,68,Domestic,9,2016-05-26,2016-05-29,5,26,243,3 days,5071635,4566208
788,10789,2,5,Tripple-fax,26-05-2016,Dayton,OH,3,Elgin,IL,27-05-2016,981,644,7343,8079,99,Domestic,5,2016-05-26,2016-05-27,5,26,736,1 days,5079714,4573551
1350,11351,3,5,zummatax,27-05-2016,Gary,IN,3,Milwaukee,WI,30-05-2016,478,478,7552,8326,50,Domestic,3,2016-05-27,2016-05-30,5,27,774,3 days,5088040,4581103
999,11000,3,6,Canetechnology,27-05-2016,Madison,WI,1,Kalamazoo,MI,28-05-2016,287,205,4617,5194,64,Intercom,1,2016-05-27,2016-05-28,5,27,577,1 days,5093234,4585720
572,10573,2,6,Gogokeying,27-05-2016,Elgin,IL,2,Cincinnati,OH,29-05-2016,721,721,8563,8918,50,Domestic,8,2016-05-27,2016-05-29,5,27,355,2 days,5102152,4594283
702,10703,1,8,Scotcan,27-05-2016,Dayton,OH,1,Elgin,IL,28-05-2016,1173,302,4050,4826,72,Domestic,7,2016-05-27,2016-05-28,5,27,776,1 days,5106978,4598333
1151,11152,3,6,Tempfan,27-05-2016,Monon,IN,3,Lansing,MI,30-05-2016,1130,518,6847,7684,65,Domestic,8,2016-05-27,2016-05-30,5,27,837,3 days,5114662,4605180
628,10629,2,5,Groovestrip,27-05-2016,Joliet,IL,3,Madison,WI,30-05-2016,205,205,7974,8918,54,Domestic,5,2016-05-27,2016-05-30,5,27,944,3 days,5123580,4613154
1313,11314,3,1,Quotefix,27-05-2016,Cincinnati,OH,3,Gary,IN,30-05-2016,459,318,542,5174,88,Domestic,8,2016-05-27,2016-05-30,5,27,4632,3 days,5128754,4613696
1503,11504,2,5,Keyzunbase,27-05-2016,Detriot,MI,2,Monon,IN,29-05-2016,436,436,5018,5128,89,Domestic,2,2016-05-27,2016-05-29,5,27,110,2 days,5133882,4618714
378,10379,1,7,Funlax,27-05-2016,Grand Rapids,MI,7,Toledo,OH,03-06-2016,200,200,2022,2539,92,International,2,2016-05-27,2016-06-03,5,27,517,7 days,5136421,4620736
211,10212,1,8,re-can,28-05-2016,Detriot,MI,2,Monon,IN,30-05-2016,759,695,401,567,65,Domestic,6,2016-05-28,2016-05-30,5,28,166,2 days,5136988,4621137
1173,11174,2,2,Donware,28-05-2016,Gary,IN,1,Milwaukee,WI,29-05-2016,1048,642,1750,2741,55,Domestic,6,2016-05-28,2016-05-29,5,28,991,1 days,5139729,4622887
395,10396,1,7,Streetplus,28-05-2016,Toledo,OH,6,Detriot,MI,03-06-2016,346,258,5455,5936,79,International,1,2016-05-28,2016-06-03,5,28,481,6 days,5145665,4628342
295,10296,2,6,Damdexon,28-05-2016,Indianapolis,IN,4,Northbrook,IL,31-05-2016,511,312,538,1135,59,Domestic,10,2016-05-28,2016-05-31,5,28,597,3 days,5146800,4628880
373,10374,2,8,Xx-canex,29-05-2016,Bangor,MI,3,Davenport,IA,01-06-2016,886,701,3501,3812,53,Domestic,4,2016-05-29,2016-06-01,5,29,311,3 days,5150612,4632381
451,10452,1,4,Labdox,29-05-2016,Northbrook,IL,7,Naperville,IL,05-06-2016,894,789,7760,5750,50,International,6,2016-05-29,2016-06-05,5,29,-2010,7 days,5156362,4640141
255,10256,1,8,villahouse,29-05-2016,Joliet,IL,4,Madison,WI,02-06-2016,1181,216,1580,1756,75,Domestic,5,2016-05-29,2016-06-02,5,29,176,4 days,5158118,4641721
1447,11448,3,1,Condexon,29-05-2016,Toledo,OH,2,Detriot,MI,31-05-2016,248,248,42,4240,51,Domestic,9,2016-05-29,2016-05-31,5,29,4198,2 days,5162358,4641763
1408,11409,3,2,Technodax,29-05-2016,Skokie,IL,2,Chicago,IL,31-05-2016,814,505,7802,8407,99,Domestic,10,2016-05-29,2016-05-31,5,29,605,2 days,5170765,4649565
922,10923,2,4,applanet,29-05-2016,Cincinnati,OH,2,Gary,IN,31-05-2016,771,475,4821,2767,67,Domestic,1,2016-05-29,2016-05-31,5,29,-2054,2 days,5173532,4654386
1223,11224,2,4,Xx-dotone,30-05-2016,Naperville,IL,2,Indianapolis,IN,01-06-2016,618,618,5974,4485,57,Domestic,2,2016-05-30,2016-06-01,5,30,-1489,2 days,5178017,4660360
1769,11770,2,4,tinron,30-05-2016,Rockford,IL,2,Green Bay,WI,01-06-2016,1078,432,6933,4673,90,Domestic,8,2016-05-30,2016-06-01,5,30,-2260,2 days,5182690,4667293
923,10924,2,4,Zoncone,30-05-2016,Dayton,OH,4,Elgin,IL,03-06-2016,1124,476,5818,4403,71,Domestic,8,2016-05-30,2016-06-03,5,30,-1415,4 days,5187093,4673111
216,10217,2,8,Freebam,30-05-2016,Green Bay,WI,7,Joliet,IL,06-06-2016,489,437,1549,1841,100,International,5,2016-05-30,2016-06-06,5,30,292,7 days,5188934,4674660
337,10338,1,8,Fasezim,30-05-2016,Indianapolis,IN,4,Northbrook,IL,31-05-2016,1087,737,6313,6651,79,Domestic,5,2016-05-30,2016-05-31,5,30,338,1 days,5195585,4680973
1457,11458,3,5,citydexon,30-05-2016,Chicago,IL,10,Rockford,IL,09-06-2016,896,320,5599,5890,88,International,3,2016-05-30,2016-06-09,5,30,291,10 days,5201475,4686572
614,10615,2,6,Planethouse,30-05-2016,Toledo,OH,10,Detriot,MI,09-06-2016,1104,765,665,1092,57,International,2,2016-05-30,2016-06-09,5,30,427,10 days,5202567,4687237
164,10165,1,6,Scotline,30-05-2016,Davenport,IA,8,Appleton,WI,07-06-2016,725,641,3633,3738,89,International,6,2016-05-30,2016-06-07,5,30,105,8 days,5206305,4690870
900,10901,1,6,Ventocore,30-05-2016,Toledo,OH,1,Detriot,MI,31-05-2016,593,593,1719,2169,58,Domestic,10,2016-05-30,2016-05-31,5,30,450,1 days,5208474,4692589
1424,11425,2,6,Namelectronics,31-05-2016,Toledo,OH,2,Detriot,MI,02-06-2016,505,505,696,916,77,Domestic,5,2016-05-31,2016-06-02,5,31,220,2 days,5209390,4693285
196,10197,1,5,Zunhouse,31-05-2016,Appleton,WI,5,Grand Rapids,MI,05-06-2016,933,361,3801,4113,65,International,3,2016-05-31,2016-06-05,5,31,312,5 days,5213503,4697086
1174,11175,3,5,Linetone,31-05-2016,Joliet,IL,1,Madison,WI,01-06-2016,945,315,40,141,60,Domestic,9,2016-05-31,2016-06-01,5,31,101,1 days,5213644,4697126
333,10334,1,8,Zaamhouse,31-05-2016,Grand Rapids,MI,4,Toledo,OH,04-06-2016,1158,403,2008,2185,91,Domestic,9,2016-05-31,2016-06-04,5,31,177,4 days,5215829,4699134
966,10967,3,2,Pluslam,31-05-2016,Skokie,IL,3,Chicago,IL,03-06-2016,1196,630,8005,8642,95,Domestic,1,2016-05-31,2016-06-03,5,31,637,3 days,5224471,4707139
739,10740,1,5,Singlejob,31-05-2016,Green Bay,WI,2,Joliet,IL,02-06-2016,1073,781,6886,7699,72,Domestic,4,2016-05-31,2016-06-02,5,31,813,2 days,5232170,4714025
244,10245,2,5,Zimex,31-05-2016,Elgin,IL,4,Cincinnati,OH,04-06-2016,1043,213,2571,3393,67,Domestic,3,2016-05-31,2016-06-04,5,31,822,4 days,5235563,4716596
1593,11594,3,5,Whitekix,31-05-2016,Joliet,IL,2,Madison,WI,01-06-2016,270,270,8414,8770,81,Domestic,2,2016-05-31,2016-06-01,5,31,356,1 days,5244333,4725010
243,10244,1,7,Howelectrics,31-05-2016,Lansing,MI,1,Dayton,OH,01-06-2016,269,269,6061,6560,54,Domestic,6,2016-05-31,2016-06-01,5,31,499,1 days,5250893,4731071
1802,11803,2,3,Villacom,01-06-2016,Grand Rapids,MI,5,Toledo,OH,06-06-2016,594,594,6902,7786,56,International,2,2016-06-01,2016-06-06,6,1,884,5 days,5258679,4737973
188,10189,1,7,D-quadlux,01-06-2016,Chicago,IL,5,Rockford,IL,03-06-2016,533,310,6977,7301,68,International,1,2016-06-01,2016-06-03,6,1,324,2 days,5265980,4744950
1666,11667,3,3,Yearcorporation,01-06-2016,Elgin,IL,3,Cincinnati,OH,04-06-2016,378,284,1555,1700,54,Domestic,8,2016-06-01,2016-06-04,6,1,145,3 days,5267680,4746505
752,10753,2,6,Zerlane,01-06-2016,Chicago,IL,4,Rockford,IL,05-06-2016,558,558,5943,6756,70,Domestic,1,2016-06-01,2016-06-05,6,1,813,4 days,5274436,4752448
81,10082,2,5,Xx-canex,01-06-2016,Chicago,IL,6,Rockford,IL,06-06-2016,649,649,7969,8439,88,International,3,2016-06-01,2016-06-06,6,1,470,5 days,5282875,4760417
79,10080,1,7,Strongcane,01-06-2016,Milwaukee,WI,1,Springfield,IL,02-06-2016,834,570,6718,7087,81,Domestic,4,2016-06-01,2016-06-02,6,1,369,1 days,5289962,4767135
996,10997,2,2,Zimjiit,01-06-2016,Gary,IN,10,Milwaukee,WI,11-06-2016,1055,252,3678,4337,90,International,5,2016-06-01,2016-06-11,6,1,659,10 days,5294299,4770813
303,10304,2,8,hottaxon,01-06-2016,Rockford,IL,10,Green Bay,WI,11-06-2016,606,606,1474,2097,91,International,1,2016-06-01,2016-06-11,6,1,623,10 days,5296396,4772287
1338,11339,2,5,Singlejob,01-06-2016,Bangor,MI,3,Davenport,IA,04-06-2016,595,595,2021,2215,91,Domestic,5,2016-06-01,2016-06-04,6,1,194,3 days,5298611,4774308
1506,11507,3,1,zotit,01-06-2016,Monon,IN,2,Lansing,MI,03-06-2016,290,290,5088,9621,87,Domestic,9,2016-06-01,2016-06-03,6,1,4533,2 days,5308232,4779396
1407,11408,3,1,Striplane,01-06-2016,Elgin,IL,2,Cincinnati,OH,03-06-2016,1038,313,6958,11527,66,Domestic,10,2016-06-01,2016-06-03,6,1,4569,2 days,5319759,4786354
1308,11309,2,2,Conelane,02-06-2016,Madison,WI,10,Kalamazoo,MI,12-06-2016,551,551,4246,4388,88,International,3,2016-06-02,2016-06-12,6,2,142,10 days,5324147,4790600
1400,11401,3,3,hexzim,02-06-2016,Rockford,IL,7,Green Bay,WI,09-06-2016,968,758,6397,6540,73,International,3,2016-06-02,2016-06-09,6,2,143,7 days,5330687,4796997
392,10393,1,4,Plextechi,02-06-2016,Appleton,WI,2,Grand Rapids,MI,04-06-2016,878,525,7935,6361,93,Domestic,5,2016-06-02,2016-06-04,6,2,-1574,2 days,5337048,4804932
305,10306,2,6,K-is,02-06-2016,Cincinnati,OH,8,Gary,IN,10-06-2016,1116,388,4145,4672,84,International,1,2016-06-02,2016-06-10,6,2,527,8 days,5341720,4809077
194,10195,1,7,Faseelectronics,02-06-2016,Green Bay,WI,4,Joliet,IL,06-06-2016,343,343,6101,6353,88,Domestic,5,2016-06-02,2016-06-06,6,2,252,4 days,5348073,4815178
629,10630,1,8,Matdex,02-06-2016,Monon,IN,2,Lansing,MI,04-06-2016,337,337,6547,7366,64,Domestic,9,2016-06-02,2016-06-04,6,2,819,2 days,5355439,4821725
169,10170,2,5,Dongtinlux,02-06-2016,Indianapolis,IN,2,Northbrook,IL,04-06-2016,836,712,2144,2515,93,Domestic,8,2016-06-02,2016-06-04,6,2,371,2 days,5357954,4823869
1693,11694,3,2,hexzim,02-06-2016,Northbrook,IL,2,Naperville,IL,04-06-2016,671,671,4751,4890,92,Domestic,6,2016-06-02,2016-06-04,6,2,139,2 days,5362844,4828620
852,10853,1,4,O-tom,02-06-2016,Appleton,WI,8,Grand Rapids,MI,10-06-2016,332,310,5580,3966,54,International,5,2016-06-02,2016-06-10,6,2,-1614,8 days,5366810,4834200
538,10539,2,6,Plustaxon,02-06-2016,Northbrook,IL,3,Naperville,IL,05-06-2016,915,594,7720,8038,61,Domestic,2,2016-06-02,2016-06-05,6,2,318,3 days,5374848,4841920
1048,11049,3,2,Saokeycane,03-06-2016,Dayton,OH,3,Elgin,IL,04-06-2016,343,343,3960,4828,77,Domestic,2,2016-06-03,2016-06-04,6,3,868,1 days,5379676,4845880
864,10865,2,3,Redozetam,03-06-2016,Chicago,IL,1,Rockford,IL,04-06-2016,519,519,7925,8692,69,Domestic,3,2016-06-03,2016-06-04,6,3,767,1 days,5388368,4853805
501,10502,1,5,Scotlex,03-06-2016,Appleton,WI,3,Grand Rapids,MI,06-06-2016,456,456,7067,7784,64,Domestic,7,2016-06-03,2016-06-06,6,3,717,3 days,5396152,4860872
124,10125,2,6,Tantax,03-06-2016,Milwaukee,WI,4,Springfield,IL,07-06-2016,622,425,7765,8068,70,Domestic,6,2016-06-03,2016-06-07,6,3,303,4 days,5404220,4868637
318,10319,1,8,Zerfax,03-06-2016,Northbrook,IL,1,Naperville,IL,04-06-2016,1131,682,7481,8435,57,Domestic,7,2016-06-03,2016-06-04,6,3,954,1 days,5412655,4876118
444,10445,2,5,Faxron,03-06-2016,Skokie,IL,4,Chicago,IL,07-06-2016,891,200,8380,8740,91,Domestic,8,2016-06-03,2016-06-07,6,3,360,4 days,5421395,4884498
1118,11119,3,5,Joygreen,03-06-2016,Kalamazoo,MI,3,Bangor,MI,06-06-2016,620,319,8454,8991,84,Domestic,9,2016-06-03,2016-06-06,6,3,537,3 days,5430386,4892952
175,10176,2,6,Yearcorporation,03-06-2016,Naperville,IL,2,Indianapolis,IN,05-06-2016,917,665,6418,6544,74,Domestic,1,2016-06-03,2016-06-05,6,3,126,2 days,5436930,4899370
1289,11290,2,3,Strongtechnology,03-06-2016,Rockford,IL,8,Green Bay,WI,11-06-2016,365,333,2614,3459,55,International,2,2016-06-03,2016-06-11,6,3,845,8 days,5440389,4901984
911,10912,2,1,Lazap,03-06-2016,Indianapolis,IN,5,Northbrook,IL,08-06-2016,407,290,627,5146,96,International,7,2016-06-03,2016-06-08,6,3,4519,5 days,5445535,4902611
1301,11302,3,6,Zotcare,03-06-2016,Chicago,IL,2,Rockford,IL,05-06-2016,569,268,4084,4658,79,Domestic,7,2016-06-03,2016-06-05,6,3,574,2 days,5450193,4906695
521,10522,2,6,zathhow,04-06-2016,Green Bay,WI,1,Joliet,IL,05-06-2016,757,690,5109,5731,52,Domestic,9,2016-06-04,2016-06-05,6,4,622,1 days,5455924,4911804
192,10193,2,8,Qvofix,04-06-2016,Monon,IN,1,Lansing,MI,05-06-2016,1196,477,2726,3391,73,Domestic,9,2016-06-04,2016-06-05,6,4,665,1 days,5459315,4914530
512,10513,1,5,ganz-is,04-06-2016,Milwaukee,WI,1,Springfield,IL,05-06-2016,1151,772,4794,5611,98,Domestic,2,2016-06-04,2016-06-05,6,4,817,1 days,5464926,4919324
1342,11343,3,3,Lamlab,04-06-2016,Davenport,IA,2,Appleton,WI,06-06-2016,254,254,6136,6378,100,Domestic,7,2016-06-04,2016-06-06,6,4,242,2 days,5471304,4925460
172,10173,1,4,Canecare,04-06-2016,Joliet,IL,2,Madison,WI,04-06-2016,750,672,3456,1506,73,Domestic,2,2016-06-04,2016-06-04,6,4,-1950,0 days,5472810,4928916
1584,11585,2,1,Ranmedia,04-06-2016,Skokie,IL,6,Chicago,IL,13-06-2016,650,382,6438,11198,54,International,6,2016-06-04,2016-06-13,6,4,4760,9 days,5484008,4935354
967,10968,3,5,Rancan,04-06-2016,Kalamazoo,MI,10,Bangor,MI,12-06-2016,316,236,4670,4923,59,International,4,2016-06-04,2016-06-12,6,4,253,8 days,5488931,4940024
1300,11301,3,2,Canetechnology,04-06-2016,Springfield,IL,1,Skokie,IL,05-06-2016,297,297,3833,4345,82,Domestic,6,2016-06-04,2016-06-05,6,4,512,1 days,5493276,4943857
1796,11797,3,5,Ventocore,04-06-2016,Toledo,OH,4,Detriot,MI,08-06-2016,1191,478,2326,2924,87,Domestic,4,2016-06-04,2016-06-08,6,4,598,4 days,5496200,4946183
1100,11101,3,2,Latgotrax,04-06-2016,Milwaukee,WI,1,Springfield,IL,05-06-2016,982,710,4948,5114,91,Domestic,5,2016-06-04,2016-06-05,6,4,166,1 days,5501314,4951131
661,10662,1,4,Scotfase,04-06-2016,Bangor,MI,10,Davenport,IA,13-06-2016,528,528,8062,6262,70,International,7,2016-06-04,2016-06-13,6,4,-1800,9 days,5507576,4959193
510,10511,2,6,Unatrax,05-06-2016,Davenport,IA,1,Appleton,WI,06-06-2016,980,296,846,1478,57,Domestic,6,2016-06-05,2016-06-06,6,5,632,1 days,5509054,4960039
590,10591,2,6,Howtaxon,05-06-2016,Cincinnati,OH,3,Gary,IN,08-06-2016,390,320,2352,3057,75,Domestic,9,2016-06-05,2016-06-08,6,5,705,3 days,5512111,4962391
480,10481,2,6,Toncode,05-06-2016,Rockford,IL,4,Green Bay,WI,09-06-2016,742,733,7120,7692,78,Domestic,8,2016-06-05,2016-06-09,6,5,572,4 days,5519803,4969511
754,10755,1,4,tres-tone,05-06-2016,Northbrook,IL,3,Naperville,IL,08-06-2016,1145,578,7944,6354,57,Domestic,2,2016-06-05,2016-06-08,6,5,-1590,3 days,5526157,4977455
1576,11577,3,6,Itdom,05-06-2016,Naperville,IL,2,Indianapolis,IN,05-06-2016,1171,376,3013,4003,74,Domestic,7,2016-06-05,2016-06-05,6,5,990,0 days,5530160,4980468
768,10769,1,5,Ganzsannix,05-06-2016,Bangor,MI,9,Davenport,IA,11-06-2016,863,288,4838,5494,80,International,2,2016-06-05,2016-06-11,6,5,656,6 days,5535654,4985306
1085,11086,3,2,Qvofix,05-06-2016,Monon,IN,10,Lansing,MI,15-06-2016,257,257,779,1274,86,International,3,2016-06-05,2016-06-15,6,5,495,10 days,5536928,4986085
1748,11749,3,4,Canex,05-06-2016,Cincinnati,OH,1,Gary,IN,06-06-2016,375,234,5321,3172,78,Domestic,7,2016-06-05,2016-06-06,6,5,-2149,1 days,5540100,4991406
417,10418,1,4,Laex,05-06-2016,Dayton,OH,7,Elgin,IL,12-06-2016,923,527,2480,269,73,International,5,2016-06-05,2016-06-12,6,5,-2211,7 days,5540369,4993886
150,10151,1,6,Faseron,05-06-2016,Detriot,MI,2,Monon,IN,07-06-2016,307,307,252,757,73,Intercom,10,2016-06-05,2016-06-07,6,5,505,2 days,5541126,4994138
668,10669,1,6,Iceelectrics,05-06-2016,Springfield,IL,3,Skokie,IL,08-06-2016,651,632,4860,5668,97,Domestic,5,2016-06-05,2016-06-08,6,5,808,3 days,5546794,4998998
1138,11139,2,1,Dingfax,05-06-2016,Bangor,MI,4,Davenport,IA,09-06-2016,417,417,5609,10727,63,Domestic,1,2016-06-05,2016-06-09,6,5,5118,4 days,5557521,5004607
26,10027,1,5,Dingity,06-06-2016,Detriot,MI,7,Monon,IN,13-06-2016,694,243,5139,6100,68,International,10,2016-06-06,2016-06-13,6,6,961,7 days,5563621,5009746
1547,11548,2,1,Unoex,06-06-2016,Chicago,IL,3,Rockford,IL,09-06-2016,264,264,1061,5773,65,Domestic,6,2016-06-06,2016-06-09,6,6,4712,3 days,5569394,5010807
280,10281,2,5,Iselectrics,06-06-2016,Green Bay,WI,4,Joliet,IL,10-06-2016,368,280,3101,3406,86,Domestic,5,2016-06-06,2016-06-10,6,6,305,4 days,5572800,5013908
790,10791,1,8,Isdexon,06-06-2016,Lansing,MI,3,Dayton,OH,09-06-2016,607,305,8286,8722,76,Domestic,4,2016-06-06,2016-06-09,6,6,436,3 days,5581522,5022194
1743,11744,2,4,Roundlam,06-06-2016,Madison,WI,9,Kalamazoo,MI,15-06-2016,638,416,5670,3395,70,International,4,2016-06-06,2016-06-15,6,6,-2275,9 days,5584917,5027864
272,10273,1,5,Zamlane,06-06-2016,Springfield,IL,2,Skokie,IL,08-06-2016,400,304,5274,5875,52,Intercom,10,2016-06-06,2016-06-08,6,6,601,2 days,5590792,5033138
1362,11363,3,1,Indibase,07-06-2016,Bangor,MI,3,Davenport,IA,10-06-2016,950,751,7050,11226,67,Domestic,9,2016-06-07,2016-06-10,6,7,4176,3 days,5602018,5040188
675,10676,1,8,Xx-canex,07-06-2016,Green Bay,WI,2,Joliet,IL,09-06-2016,955,234,1109,1943,76,Domestic,1,2016-06-07,2016-06-09,6,7,834,2 days,5603961,5041297
442,10443,2,6,Singlejob,07-06-2016,Bangor,MI,10,Davenport,IA,16-06-2016,591,201,7485,7774,53,International,5,2016-06-07,2016-06-16,6,7,289,9 days,5611735,5048782
319,10320,2,5,Zoncone,07-06-2016,Joliet,IL,2,Madison,WI,08-06-2016,797,450,8026,8699,98,Domestic,7,2016-06-07,2016-06-08,6,7,673,1 days,5620434,5056808
1071,11072,2,1,Dentoelectrics,07-06-2016,Bangor,MI,3,Davenport,IA,10-06-2016,301,301,1780,5748,86,Domestic,2,2016-06-07,2016-06-10,6,7,3968,3 days,5626182,5058588
1638,11639,2,1,Ozeris,07-06-2016,Madison,WI,8,Kalamazoo,MI,15-06-2016,452,380,7839,12996,53,International,6,2016-06-07,2016-06-15,6,7,5157,8 days,5639178,5066427
1110,11111,3,2,Sonzamace,07-06-2016,Rockford,IL,1,Green Bay,WI,08-06-2016,598,304,5026,5597,96,Domestic,7,2016-06-07,2016-06-08,6,7,571,1 days,5644775,5071453
28,10029,2,5,Overtam,07-06-2016,Madison,WI,1,Kalamazoo,MI,08-06-2016,1123,733,7614,8038,79,Intercom,2,2016-06-07,2016-06-08,6,7,424,1 days,5652813,5079067
1404,11405,2,1,Latgotrax,07-06-2016,Toledo,OH,7,Detriot,MI,21-03-2016,1183,297,988,6289,71,International,5,2016-06-07,2016-03-21,6,7,5301,-78 days,5659102,5080055
1021,11022,3,6,Goodquoing,07-06-2016,Monon,IN,3,Lansing,MI,10-06-2016,1058,466,551,1504,51,Domestic,4,2016-06-07,2016-06-10,6,7,953,3 days,5660606,5080606
1436,11437,3,3,Plustaxon,08-06-2016,Northbrook,IL,9,Naperville,IL,17-06-2016,801,273,5474,5634,65,International,2,2016-06-08,2016-06-17,6,8,160,9 days,5666240,5086080
1772,11773,3,5,Linetone,08-06-2016,Dayton,OH,3,Elgin,IL,09-06-2016,650,557,3809,4497,73,Domestic,3,2016-06-08,2016-06-09,6,8,688,1 days,5670737,5089889
906,10907,1,2,K-is,08-06-2016,Davenport,IA,1,Appleton,WI,09-06-2016,787,688,4886,5487,86,Domestic,5,2016-06-08,2016-06-09,6,8,601,1 days,5676224,5094775
224,10225,1,7,Joygreen,08-06-2016,Kalamazoo,MI,2,Bangor,MI,10-06-2016,958,406,8395,8500,91,Domestic,5,2016-06-08,2016-06-10,6,8,105,2 days,5684724,5103170
199,10200,1,5,white-high,08-06-2016,Toledo,OH,7,Detriot,MI,21-03-2016,1146,670,6868,7134,92,International,2,2016-06-08,2016-03-21,6,8,266,-79 days,5691858,5110038
1470,11471,3,5,Zamlane,08-06-2016,Lansing,MI,3,Dayton,OH,11-06-2016,476,385,4417,4696,58,Domestic,10,2016-06-08,2016-06-11,6,8,279,3 days,5696554,5114455
902,10903,2,2,Recode,08-06-2016,Bangor,MI,3,Davenport,IA,11-06-2016,707,423,5214,5385,99,Domestic,5,2016-06-08,2016-06-11,6,8,171,3 days,5701939,5119669
100,10101,1,6,Plextechi,09-06-2016,Kalamazoo,MI,5,Bangor,MI,13-06-2016,861,731,8088,8367,95,International,1,2016-06-09,2016-06-13,6,9,279,4 days,5710306,5127757
954,10955,2,4,tamplex,09-06-2016,Northbrook,IL,1,Naperville,IL,10-06-2016,703,421,7873,5743,98,Domestic,1,2016-06-09,2016-06-10,6,9,-2130,1 days,5716049,5135630
422,10423,1,8,D-zohex,09-06-2016,Skokie,IL,1,Chicago,IL,10-06-2016,757,251,615,1009,94,Domestic,6,2016-06-09,2016-06-10,6,9,394,1 days,5717058,5136245
1195,11196,3,4,Conzumzap,09-06-2016,Detriot,MI,1,Monon,IN,10-06-2016,337,337,2702,954,65,Domestic,3,2016-06-09,2016-06-10,6,9,-1748,1 days,5718012,5138947
421,10422,1,8,Tamtexon,09-06-2016,Elgin,IL,1,Cincinnati,OH,10-06-2016,596,559,3861,4050,64,Domestic,5,2016-06-09,2016-06-10,6,9,189,1 days,5722062,5142808
846,10847,2,1,una-phase,09-06-2016,Joliet,IL,1,Madison,WI,10-06-2016,577,577,8199,13410,85,Domestic,9,2016-06-09,2016-06-10,6,9,5211,1 days,5735472,5151007
1252,11253,2,1,Plusla,09-06-2016,Bangor,MI,1,Davenport,IA,10-06-2016,597,597,7134,11967,53,Domestic,1,2016-06-09,2016-06-10,6,9,4833,1 days,5747439,5158141
1676,11677,2,5,Gravemedia,09-06-2016,Gary,IN,1,Milwaukee,WI,10-06-2016,1000,704,3152,3931,71,Domestic,7,2016-06-09,2016-06-10,6,9,779,1 days,5751370,5161293
1367,11368,2,1,Canecare,09-06-2016,Grand Rapids,MI,10,Toledo,OH,19-06-2016,619,446,2293,6418,54,International,3,2016-06-09,2016-06-19,6,9,4125,10 days,5757788,5163586
606,10607,1,7,Villacom,09-06-2016,Joliet,IL,2,Madison,WI,10-06-2016,1160,650,2334,3067,76,Domestic,9,2016-06-09,2016-06-10,6,9,733,1 days,5760855,5165920
96,10097,2,5,Ronlamice,09-06-2016,Lansing,MI,1,Dayton,OH,10-06-2016,293,293,6384,6606,54,Intercom,1,2016-06-09,2016-06-10,6,9,222,1 days,5767461,5172304
504,10505,2,8,Latgotrax,09-06-2016,Toledo,OH,7,Detriot,MI,16-06-2016,369,229,5364,6299,82,International,6,2016-06-09,2016-06-16,6,9,935,7 days,5773760,5177668
1182,11183,3,6,Reddoit,09-06-2016,Dayton,OH,10,Elgin,IL,19-06-2016,938,226,3751,4175,58,International,3,2016-06-09,2016-06-19,6,9,424,10 days,5777935,5181419
1208,11209,3,5,Lazap,09-06-2016,Elgin,IL,4,Cincinnati,OH,12-06-2016,476,476,7600,7783,93,Domestic,9,2016-06-09,2016-06-12,6,9,183,3 days,5785718,5189019
1689,11690,2,2,Runhigh,09-06-2016,Grand Rapids,MI,8,Toledo,OH,17-06-2016,744,464,2897,3354,65,International,8,2016-06-09,2016-06-17,6,9,457,8 days,5789072,5191916
1255,11256,2,5,Dontam,10-06-2016,Springfield,IL,2,Skokie,IL,12-06-2016,1075,610,6371,6907,57,Intercom,1,2016-06-10,2016-06-12,6,10,536,2 days,5795979,5198287
1740,11741,3,2,Silver-line,10-06-2016,Gary,IN,3,Milwaukee,WI,13-06-2016,988,584,3354,4279,61,Domestic,8,2016-06-10,2016-06-13,6,10,925,3 days,5800258,5201641
1780,11781,3,3,Reddoit,10-06-2016,Grand Rapids,MI,2,Toledo,OH,11-06-2016,617,481,8090,8398,93,Domestic,9,2016-06-10,2016-06-11,6,10,308,1 days,5808656,5209731
1011,11012,2,2,Quotefix,10-06-2016,Davenport,IA,2,Appleton,WI,12-06-2016,1184,373,7125,7824,93,Domestic,3,2016-06-10,2016-06-12,6,10,699,2 days,5816480,5216856
499,10500,1,6,Dingcan,10-06-2016,Green Bay,WI,4,Joliet,IL,14-06-2016,1027,756,4805,5786,67,Domestic,7,2016-06-10,2016-06-14,6,10,981,4 days,5822266,5221661
406,10407,1,6,Solostreet,11-06-2016,Indianapolis,IN,2,Northbrook,IL,11-06-2016,242,242,5721,6307,89,Domestic,10,2016-06-11,2016-06-11,6,11,586,0 days,5828573,5227382
459,10460,1,5,unaity,11-06-2016,Appleton,WI,8,Grand Rapids,MI,17-06-2016,1195,586,5137,5404,79,International,6,2016-06-11,2016-06-17,6,11,267,6 days,5833977,5232519
354,10355,2,7,Faseway,11-06-2016,Grand Rapids,MI,2,Toledo,OH,12-06-2016,741,707,3920,4540,73,Domestic,2,2016-06-11,2016-06-12,6,11,620,1 days,5838517,5236439
1319,11320,2,5,Joyancom,12-06-2016,Kalamazoo,MI,4,Bangor,MI,16-06-2016,1037,378,7661,8016,66,Domestic,3,2016-06-12,2016-06-16,6,12,355,4 days,5846533,5244100
1105,11106,2,1,Unatrax,12-06-2016,Gary,IN,7,Milwaukee,WI,19-06-2016,1127,223,537,4845,54,International,9,2016-06-12,2016-06-19,6,12,4308,7 days,5851378,5244637
1499,11500,3,5,Ventocore,12-06-2016,Milwaukee,WI,1,Springfield,IL,13-06-2016,656,236,6946,7305,91,Domestic,8,2016-06-12,2016-06-13,6,12,359,1 days,5858683,5251583
315,10316,2,7,Overtam,12-06-2016,Springfield,IL,3,Skokie,IL,15-06-2016,274,274,5279,5973,98,Domestic,4,2016-06-12,2016-06-15,6,12,694,3 days,5864656,5256862
918,10919,3,6,Solholdings,12-06-2016,Green Bay,WI,8,Joliet,IL,17-06-2016,801,730,7362,7580,67,International,7,2016-06-12,2016-06-17,6,12,218,5 days,5872236,5264224
1484,11485,3,6,Plustax,12-06-2016,Monon,IN,3,Lansing,MI,15-06-2016,942,645,1309,1583,71,Domestic,8,2016-06-12,2016-06-15,6,12,274,3 days,5873819,5265533
937,10938,3,5,zoofan,12-06-2016,Monon,IN,2,Lansing,MI,14-06-2016,912,785,7289,8186,94,Domestic,4,2016-06-12,2016-06-14,6,12,897,2 days,5882005,5272822
106,10107,2,5,Quotefix,13-06-2016,Indianapolis,IN,4,Northbrook,IL,17-06-2016,830,265,1536,1894,82,Domestic,6,2016-06-13,2016-06-17,6,13,358,4 days,5883899,5274358
1235,11236,2,6,zoofan,13-06-2016,Milwaukee,WI,5,Springfield,IL,18-06-2016,323,323,3233,3591,60,International,2,2016-06-13,2016-06-18,6,13,358,5 days,5887490,5277591
745,10746,1,5,planetron,13-06-2016,Toledo,OH,5,Detriot,MI,21-03-2016,863,636,7674,8644,75,International,6,2016-06-13,2016-03-21,6,13,970,-84 days,5896134,5285265
412,10413,2,5,Matsanice,13-06-2016,Green Bay,WI,1,Joliet,IL,14-06-2016,660,418,2617,3435,54,Domestic,8,2016-06-13,2016-06-14,6,13,818,1 days,5899569,5287882
1611,11612,3,4,Plusity,13-06-2016,Detriot,MI,1,Monon,IN,14-06-2016,219,219,3790,2095,85,Domestic,1,2016-06-13,2016-06-14,6,13,-1695,1 days,5901664,5291672
1251,11252,2,2,Vaiazozice,13-06-2016,Lansing,MI,3,Dayton,OH,16-06-2016,954,725,8128,8237,87,Domestic,8,2016-06-13,2016-06-16,6,13,109,3 days,5909901,5299800
1514,11515,3,5,Planethouse,13-06-2016,Toledo,OH,8,Detriot,MI,21-03-2016,905,370,5678,6501,90,International,10,2016-06-13,2016-03-21,6,13,823,-84 days,5916402,5305478
1154,11155,3,4,Ittam,13-06-2016,Naperville,IL,4,Indianapolis,IN,17-06-2016,1050,266,7866,5649,82,Domestic,5,2016-06-13,2016-06-17,6,13,-2217,4 days,5922051,5313344
223,10224,1,6,Saltfan,13-06-2016,Skokie,IL,3,Chicago,IL,16-06-2016,506,410,3997,4478,99,Domestic,5,2016-06-13,2016-06-16,6,13,481,3 days,5926529,5317341
1348,11349,2,6,Labdox,14-06-2016,Northbrook,IL,7,Naperville,IL,21-03-2016,937,270,5033,5886,78,International,3,2016-06-14,2016-03-21,6,14,853,-85 days,5932415,5322374
1673,11674,2,5,Dentoelectrics,14-06-2016,Chicago,IL,8,Rockford,IL,22-06-2016,751,529,6673,7298,69,International,3,2016-06-14,2016-06-22,6,14,625,8 days,5939713,5329047
1529,11530,3,2,Groovestrip,14-06-2016,Joliet,IL,2,Madison,WI,15-06-2016,219,219,163,265,94,Domestic,4,2016-06-14,2016-06-15,6,14,102,1 days,5939978,5329210
1601,11602,3,5,Duoflex,14-06-2016,Toledo,OH,5,Detriot,MI,21-06-2016,501,501,4122,5083,94,International,4,2016-06-14,2016-06-21,6,14,961,7 days,5945061,5333332
736,10737,1,7,Hexunobam,14-06-2016,Detriot,MI,1,Monon,IN,15-06-2016,533,370,1152,1813,58,Domestic,3,2016-06-14,2016-06-15,6,14,661,1 days,5946874,5334484
934,10935,3,1,Instrip,14-06-2016,Detriot,MI,5,Monon,IN,17-06-2016,1006,403,6172,10586,71,International,3,2016-06-14,2016-06-17,6,14,4414,3 days,5957460,5340656
404,10405,2,5,Canetechnology,14-06-2016,Springfield,IL,5,Skokie,IL,17-06-2016,419,419,4112,4363,58,International,6,2016-06-14,2016-06-17,6,14,251,3 days,5961823,5344768
1518,11519,3,4,Zerfax,15-06-2016,Skokie,IL,2,Chicago,IL,17-06-2016,560,345,2174,616,88,Domestic,6,2016-06-15,2016-06-17,6,15,-1558,2 days,5962439,5346942
769,10770,1,4,Yearcorporation,15-06-2016,Elgin,IL,4,Cincinnati,OH,18-06-2016,536,416,7095,4753,50,Domestic,7,2016-06-15,2016-06-18,6,15,-2342,3 days,5967192,5354037
207,10208,1,5,hotity,15-06-2016,Springfield,IL,2,Skokie,IL,17-06-2016,355,355,5635,6038,55,Domestic,2,2016-06-15,2016-06-17,6,15,403,2 days,5973230,5359672
1623,11624,3,4,Fasetech,15-06-2016,Lansing,MI,2,Dayton,OH,17-06-2016,326,326,6463,4767,60,Intercom,3,2016-06-15,2016-06-17,6,15,-1696,2 days,5977997,5366135
1556,11557,2,1,nimlab,15-06-2016,Naperville,IL,2,Indianapolis,IN,17-06-2016,249,249,5892,10387,100,Domestic,10,2016-06-15,2016-06-17,6,15,4495,2 days,5988384,5372027
185,10186,2,6,Alphadax,15-06-2016,Grand Rapids,MI,1,Toledo,OH,16-06-2016,324,323,623,1108,84,Domestic,3,2016-06-15,2016-06-16,6,15,485,1 days,5989492,5372650
915,10916,3,1,Duodax,15-06-2016,Joliet,IL,1,Madison,WI,16-06-2016,410,410,1941,6905,91,Domestic,3,2016-06-15,2016-06-16,6,15,4964,1 days,5996397,5374591
673,10674,2,5,Strongcane,15-06-2016,Monon,IN,7,Lansing,MI,21-03-2016,965,311,7654,8317,89,International,6,2016-06-15,2016-03-21,6,15,663,-86 days,6004714,5382245
1563,11564,3,2,Newzap,15-06-2016,Elgin,IL,3,Cincinnati,OH,21-06-2016,559,559,1798,2151,64,Domestic,5,2016-06-15,2016-06-21,6,15,353,6 days,6006865,5384043
363,10364,1,4,geofind,15-06-2016,Monon,IN,1,Lansing,MI,16-06-2016,500,500,7089,4982,65,Domestic,5,2016-06-15,2016-06-16,6,15,-2107,1 days,6011847,5391132
432,10433,2,7,stripzim,15-06-2016,Joliet,IL,2,Madison,WI,15-06-2016,447,430,5142,5287,92,Domestic,3,2016-06-15,2016-06-15,6,15,145,0 days,6017134,5396274
1692,11693,3,3,Opebase,15-06-2016,Indianapolis,IN,1,Northbrook,IL,16-06-2016,836,251,7981,8370,83,Domestic,6,2016-06-15,2016-06-16,6,15,389,1 days,6025504,5404255
1695,11696,2,3,Good-find,16-06-2016,Gary,IN,9,Milwaukee,WI,23-06-2016,312,297,1816,2285,73,International,4,2016-06-16,2016-06-23,6,16,469,7 days,6027789,5406071
489,10490,2,8,Anzammedia,16-06-2016,Kalamazoo,MI,5,Bangor,MI,21-06-2016,1159,712,7897,8006,73,International,6,2016-06-16,2016-06-21,6,16,109,5 days,6035795,5413968
371,10372,2,5,Strongcane,16-06-2016,Toledo,OH,3,Detriot,MI,19-06-2016,679,616,2477,3019,67,Domestic,9,2016-06-16,2016-06-19,6,16,542,3 days,6038814,5416445
1153,11154,2,5,citydexon,16-06-2016,Green Bay,WI,1,Joliet,IL,17-06-2016,1079,564,6387,6801,60,Domestic,9,2016-06-16,2016-06-17,6,16,414,1 days,6045615,5422832
951,10952,2,5,Kincorporation,16-06-2016,Milwaukee,WI,1,Springfield,IL,17-06-2016,527,527,8424,8643,57,Domestic,2,2016-06-16,2016-06-17,6,16,219,1 days,6054258,5431256
1030,11031,2,5,Ronvivalam,16-06-2016,Lansing,MI,2,Dayton,OH,18-06-2016,924,287,6145,6506,93,Domestic,2,2016-06-16,2016-06-18,6,16,361,2 days,6060764,5437401
734,10735,1,5,Faxotfind,16-06-2016,Indianapolis,IN,2,Northbrook,IL,17-06-2016,413,413,5610,6262,79,Domestic,7,2016-06-16,2016-06-17,6,16,652,1 days,6067026,5443011
576,10577,2,4,Linetone,16-06-2016,Grand Rapids,MI,2,Toledo,OH,16-06-2016,301,301,6622,4610,67,Domestic,5,2016-06-16,2016-06-16,6,16,-2012,0 days,6071636,5449633
1713,11714,2,2,Zunzone,17-06-2016,Milwaukee,WI,2,Springfield,IL,19-06-2016,427,427,4010,4480,96,Domestic,10,2016-06-17,2016-06-19,6,17,470,2 days,6076116,5453643
1552,11553,2,6,Physcone,17-06-2016,Joliet,IL,6,Madison,WI,26-06-2016,1196,383,4973,5231,100,International,3,2016-06-17,2016-06-26,6,17,258,9 days,6081347,5458616
202,10203,2,5,Opebase,17-06-2016,Elgin,IL,3,Cincinnati,OH,20-06-2016,721,511,6773,7092,88,Domestic,3,2016-06-17,2016-06-20,6,17,319,3 days,6088439,5465389
289,10290,1,6,O-job,17-06-2016,Kalamazoo,MI,1,Bangor,MI,18-06-2016,293,293,5608,6000,83,Intercom,8,2016-06-17,2016-06-18,6,17,392,1 days,6094439,5470997
1612,11613,3,5,Quotefix,17-06-2016,Gary,IN,4,Milwaukee,WI,21-06-2016,1096,628,6646,7458,58,Domestic,4,2016-06-17,2016-06-21,6,17,812,4 days,6101897,5477643
77,10078,1,5,Singleholdings,17-06-2016,Davenport,IA,4,Appleton,WI,21-06-2016,858,677,7105,7478,70,Domestic,6,2016-06-17,2016-06-21,6,17,373,4 days,6109375,5484748
889,10890,2,2,O-job,17-06-2016,Detriot,MI,6,Monon,IN,23-06-2016,450,450,5092,5456,80,International,2,2016-06-17,2016-06-23,6,17,364,6 days,6114831,5489840
622,10623,2,8,Canemedkix,18-06-2016,Milwaukee,WI,4,Springfield,IL,22-06-2016,656,257,389,533,71,Domestic,9,2016-06-18,2016-06-22,6,18,144,4 days,6115364,5490229
1536,11537,3,6,xx-bam,18-06-2016,Cincinnati,OH,2,Gary,IN,20-06-2016,719,547,5523,6425,67,Domestic,7,2016-06-18,2016-06-20,6,18,902,2 days,6121789,5495752
1533,11534,2,1,Bamtechnology,18-06-2016,Naperville,IL,7,Indianapolis,IN,28-06-2016,602,342,3928,7575,93,International,1,2016-06-18,2016-06-28,6,18,3647,10 days,6129364,5499680
1699,11700,3,6,Scothouse,18-06-2016,Green Bay,WI,3,Joliet,IL,21-06-2016,449,412,2136,3063,56,Domestic,10,2016-06-18,2016-06-21,6,18,927,3 days,6132427,5501816
461,10462,2,8,Daltcare,19-06-2016,Dayton,OH,2,Elgin,IL,19-06-2016,629,286,1175,1282,96,Domestic,1,2016-06-19,2016-06-19,6,19,107,0 days,6133709,5502991
469,10470,2,7,Zumcane,19-06-2016,Milwaukee,WI,6,Springfield,IL,25-06-2016,642,642,5333,6082,77,International,5,2016-06-19,2016-06-25,6,19,749,6 days,6139791,5508324
797,10798,1,4,Dingcan,19-06-2016,Chicago,IL,5,Rockford,IL,24-06-2016,322,322,6371,4929,78,International,3,2016-06-19,2016-06-24,6,19,-1442,5 days,6144720,5514695
1139,11140,3,2,Zimex,19-06-2016,Elgin,IL,2,Cincinnati,OH,20-06-2016,515,245,2199,3038,75,Domestic,9,2016-06-19,2016-06-20,6,19,839,1 days,6147758,5516894
1798,11799,2,6,Recode,19-06-2016,Bangor,MI,2,Davenport,IA,21-06-2016,736,321,7013,7492,80,Domestic,2,2016-06-19,2016-06-21,6,19,479,2 days,6155250,5523907
492,10493,2,6,Faseelectronics,19-06-2016,Chicago,IL,2,Rockford,IL,21-06-2016,371,371,1218,1838,97,Domestic,10,2016-06-19,2016-06-21,6,19,620,2 days,6157088,5525125
1606,11607,3,6,Donglax,19-06-2016,Davenport,IA,4,Appleton,WI,23-06-2016,291,291,8085,8921,99,Domestic,9,2016-06-19,2016-06-23,6,19,836,4 days,6166009,5533210
405,10406,2,4,Zotcare,20-06-2016,Chicago,IL,9,Rockford,IL,26-06-2016,266,266,3738,1277,98,International,4,2016-06-20,2016-06-26,6,20,-2461,6 days,6167286,5536948
1579,11580,3,2,Funlax,20-06-2016,Dayton,OH,4,Elgin,IL,27-06-2016,412,296,4733,4930,52,Domestic,7,2016-06-20,2016-06-27,6,20,197,7 days,6172216,5541681
138,10139,2,5,Dingquokix,20-06-2016,Toledo,OH,2,Detriot,MI,22-06-2016,589,589,3886,4241,52,Domestic,5,2016-06-20,2016-06-22,6,20,355,2 days,6176457,5545567
112,10113,1,4,Xx-planet,20-06-2016,Rockford,IL,10,Green Bay,WI,21-03-2016,360,316,2687,776,94,International,1,2016-06-20,2016-03-21,6,20,-1911,-91 days,6177233,5548254
716,10717,1,6,Quotefix,20-06-2016,Gary,IN,5,Milwaukee,WI,23-06-2016,479,479,1518,2165,77,International,2,2016-06-20,2016-06-23,6,20,647,3 days,6179398,5549772
1086,11087,3,1,Faseelectronics,20-06-2016,Green Bay,WI,9,Joliet,IL,29-06-2016,950,284,5895,10787,62,International,6,2016-06-20,2016-06-29,6,20,4892,9 days,6190185,5555667
816,10817,2,7,Statway,21-06-2016,Grand Rapids,MI,10,Toledo,OH,01-07-2016,398,398,2787,3575,80,International,7,2016-06-21,2016-07-01,6,21,788,10 days,6193760,5558454
231,10232,1,8,Tonsanhigh,21-06-2016,Detriot,MI,7,Monon,IN,28-06-2016,658,658,5263,5873,77,International,6,2016-06-21,2016-06-28,6,21,610,7 days,6199633,5563717
975,10976,2,1,Saozoomtex,22-06-2016,Gary,IN,2,Milwaukee,WI,24-06-2016,295,295,1592,6772,89,Domestic,5,2016-06-22,2016-06-24,6,22,5180,2 days,6206405,5565309
577,10578,1,8,Goldentechi,22-06-2016,Springfield,IL,9,Skokie,IL,01-07-2016,614,521,1420,2018,68,International,8,2016-06-22,2016-07-01,6,22,598,9 days,6208423,5566729
1087,11088,3,2,Solozap,22-06-2016,Naperville,IL,7,Indianapolis,IN,29-06-2016,726,208,3723,4286,64,International,10,2016-06-22,2016-06-29,6,22,563,7 days,6212709,5570452
1701,11702,2,2,Technodax,22-06-2016,Rockford,IL,1,Green Bay,WI,23-06-2016,1060,787,8454,8721,85,Domestic,1,2016-06-22,2016-06-23,6,22,267,1 days,6221430,5578906
670,10671,1,7,Vaiataxon,22-06-2016,Indianapolis,IN,2,Northbrook,IL,22-06-2016,785,712,7847,8389,61,Domestic,8,2016-06-22,2016-06-22,6,22,542,0 days,6229819,5586753
84,10085,2,7,Duo-fase,22-06-2016,Detriot,MI,1,Monon,IN,23-06-2016,818,705,7012,7890,89,Domestic,8,2016-06-22,2016-06-23,6,22,878,1 days,6237709,5593765
1320,11321,3,3,Goodtechno,22-06-2016,Davenport,IA,2,Appleton,WI,24-06-2016,436,436,6982,7559,74,Domestic,6,2016-06-22,2016-06-24,6,22,577,2 days,6245268,5600747
279,10280,2,7,Goldentechi,22-06-2016,Madison,WI,1,Kalamazoo,MI,23-06-2016,925,293,5266,6049,78,Domestic,6,2016-06-22,2016-06-23,6,22,783,1 days,6251317,5606013
39,10040,1,8,Sanin,23-06-2016,Kalamazoo,MI,2,Bangor,MI,25-06-2016,363,363,7941,8874,78,Domestic,1,2016-06-23,2016-06-25,6,23,933,2 days,6260191,5613954
1102,11103,2,6,Striplane,23-06-2016,Indianapolis,IN,2,Northbrook,IL,24-06-2016,1070,535,3071,3892,83,Domestic,7,2016-06-23,2016-06-24,6,23,821,1 days,6264083,5617025
340,10341,2,8,Tamholding,23-06-2016,Gary,IN,9,Milwaukee,WI,02-07-2016,412,412,7810,8365,70,International,6,2016-06-23,2016-07-02,6,23,555,9 days,6272448,5624835
1751,11752,3,3,Vivazim,24-06-2016,Lansing,MI,6,Dayton,OH,28-06-2016,1118,357,7938,8895,62,International,4,2016-06-24,2016-06-28,6,24,957,4 days,6281343,5632773
1283,11284,2,1,Templax,24-06-2016,Gary,IN,4,Milwaukee,WI,28-06-2016,365,365,5073,9144,51,Domestic,1,2016-06-24,2016-06-28,6,24,4071,4 days,6290487,5637846
914,10915,3,3,Fax-ex,24-06-2016,Gary,IN,2,Milwaukee,WI,26-06-2016,1145,400,6693,6834,80,Domestic,2,2016-06-24,2016-06-26,6,24,141,2 days,6297321,5644539
994,10995,3,1,Quotefix,24-06-2016,Indianapolis,IN,2,Northbrook,IL,25-06-2016,1108,792,6900,11576,96,Domestic,6,2016-06-24,2016-06-25,6,24,4676,1 days,6308897,5651439
1054,11055,2,6,Scotline,24-06-2016,Davenport,IA,1,Appleton,WI,25-06-2016,949,439,1549,2488,65,Domestic,7,2016-06-24,2016-06-25,6,24,939,1 days,6311385,5652988
1664,11665,3,2,Zerhouse,25-06-2016,Lansing,MI,4,Dayton,OH,29-06-2016,1062,645,4637,5085,64,Domestic,7,2016-06-25,2016-06-29,6,25,448,4 days,6316470,5657625
1747,11748,2,3,O-tom,25-06-2016,Appleton,WI,2,Grand Rapids,MI,27-06-2016,244,244,1798,2147,58,Intercom,7,2016-06-25,2016-06-27,6,25,349,2 days,6318617,5659423
720,10721,2,4,Zapline,25-06-2016,Green Bay,WI,3,Joliet,IL,28-06-2016,1141,420,5991,3543,60,Domestic,4,2016-06-25,2016-06-28,6,25,-2448,3 days,6322160,5665414
1020,11021,3,3,Zunice,25-06-2016,Joliet,IL,4,Madison,WI,29-06-2016,1078,782,6338,6605,95,Domestic,8,2016-06-25,2016-06-29,6,25,267,4 days,6328765,5671752
817,10818,2,4,Zunzone,25-06-2016,Milwaukee,WI,8,Springfield,IL,21-03-2016,452,452,2716,40,88,International,4,2016-06-25,2016-03-21,6,25,-2676,-96 days,6328805,5674468
1249,11250,3,5,Physcone,25-06-2016,Dayton,OH,2,Elgin,IL,27-06-2016,1155,376,5700,6380,97,Domestic,2,2016-06-25,2016-06-27,6,25,680,2 days,6335185,5680168
1084,11085,2,1,Tripple-fax,25-06-2016,Joliet,IL,4,Madison,WI,28-06-2016,794,706,388,4931,77,Domestic,3,2016-06-25,2016-06-28,6,25,4543,3 days,6340116,5680556
228,10229,2,4,Donremlane,26-06-2016,Chicago,IL,4,Rockford,IL,30-06-2016,778,342,5315,2945,86,Domestic,8,2016-06-26,2016-06-30,6,26,-2370,4 days,6343061,5685871
940,10941,2,1,Fasezim,26-06-2016,Naperville,IL,1,Indianapolis,IN,27-06-2016,902,742,2511,7397,83,Domestic,9,2016-06-26,2016-06-27,6,26,4886,1 days,6350458,5688382
367,10368,2,7,Pluslam,26-06-2016,Rockford,IL,2,Green Bay,WI,28-06-2016,493,319,1182,1736,90,Domestic,9,2016-06-26,2016-06-28,6,26,554,2 days,6352194,5689564
262,10263,1,4,Blue-tech,26-06-2016,Dayton,OH,2,Elgin,IL,28-06-2016,226,223,7093,4947,85,Domestic,8,2016-06-26,2016-06-28,6,26,-2146,2 days,6357141,5696657
528,10529,1,5,Donremlane,26-06-2016,Bangor,MI,1,Davenport,IA,27-06-2016,372,372,6537,6803,72,Domestic,3,2016-06-26,2016-06-27,6,26,266,1 days,6363944,5703194
731,10732,1,7,Dingquokix,26-06-2016,Milwaukee,WI,1,Springfield,IL,27-06-2016,793,674,2050,2792,83,Domestic,9,2016-06-26,2016-06-27,6,26,742,1 days,6366736,5705244
290,10291,2,8,Howtaxon,26-06-2016,Davenport,IA,3,Appleton,WI,29-06-2016,703,578,7900,8046,82,Domestic,6,2016-06-26,2016-06-29,6,26,146,3 days,6374782,5713144
957,10958,2,3,Dontam,26-06-2016,Madison,WI,2,Kalamazoo,MI,28-06-2016,331,331,7268,7620,52,Domestic,4,2016-06-26,2016-06-28,6,26,352,2 days,6382402,5720412
759,10760,2,8,Ontohatron,26-06-2016,Madison,WI,7,Kalamazoo,MI,03-07-2016,265,265,2305,3222,71,International,9,2016-06-26,2016-07-03,6,26,917,7 days,6385624,5722717
1485,11486,2,4,bamity,27-06-2016,Madison,WI,1,Kalamazoo,MI,28-06-2016,964,328,5692,3893,85,Domestic,3,2016-06-27,2016-06-28,6,27,-1799,1 days,6389517,5728409
97,10098,2,5,Zummatexon,27-06-2016,Bangor,MI,2,Davenport,IA,29-06-2016,335,204,6827,7676,79,Domestic,4,2016-06-27,2016-06-29,6,27,849,2 days,6397193,5735236
1560,11561,3,1,Tripplekix,27-06-2016,Toledo,OH,2,Detriot,MI,29-06-2016,254,230,2500,7369,59,Domestic,3,2016-06-27,2016-06-29,6,27,4869,2 days,6404562,5737736
1286,11287,3,3,Ronlamice,27-06-2016,Madison,WI,3,Kalamazoo,MI,30-06-2016,1035,505,1460,1860,79,Domestic,2,2016-06-27,2016-06-30,6,27,400,3 days,6406422,5739196
943,10944,3,6,Greentech,27-06-2016,Dayton,OH,3,Elgin,IL,27-06-2016,588,307,5958,6751,52,Domestic,3,2016-06-27,2016-06-27,6,27,793,0 days,6413173,5745154
1715,11716,3,5,zathhow,27-06-2016,Chicago,IL,10,Rockford,IL,04-07-2016,530,343,4762,5480,90,International,6,2016-06-27,2016-07-04,6,27,718,7 days,6418653,5749916
1620,11621,2,1,Goodtechno,28-06-2016,Cincinnati,OH,7,Gary,IN,07-07-2016,749,612,708,6373,77,International,5,2016-06-28,2016-07-07,6,28,5665,9 days,6425026,5750624
1331,11332,2,3,Faxotfind,28-06-2016,Naperville,IL,4,Indianapolis,IN,02-07-2016,974,622,3426,3739,53,Domestic,4,2016-06-28,2016-07-02,6,28,313,4 days,6428765,5754050
1260,11261,3,3,Dongbiolex,28-06-2016,Gary,IN,6,Milwaukee,WI,02-07-2016,927,542,3289,4159,65,International,7,2016-06-28,2016-07-02,6,28,870,4 days,6432924,5757339
651,10652,1,7,Physcone,28-06-2016,Joliet,IL,1,Madison,WI,28-06-2016,903,282,7351,8272,51,Domestic,1,2016-06-28,2016-06-28,6,28,921,0 days,6441196,5764690
962,10963,3,4,J-lax,28-06-2016,Dayton,OH,5,Elgin,IL,03-07-2016,1115,551,3404,1013,100,International,9,2016-06-28,2016-07-03,6,28,-2391,5 days,6442209,5768094
269,10270,1,8,Zathlane,28-06-2016,Davenport,IA,8,Appleton,WI,06-07-2016,950,502,2060,3030,60,International,6,2016-06-28,2016-07-06,6,28,970,8 days,6445239,5770154
707,10708,1,7,Xx-planet,28-06-2016,Skokie,IL,5,Chicago,IL,03-07-2016,697,346,2292,2407,80,International,1,2016-06-28,2016-07-03,6,28,115,5 days,6447646,5772446
1399,11400,2,5,Opebase,28-06-2016,Naperville,IL,4,Indianapolis,IN,29-06-2016,1018,229,8126,8410,67,Domestic,7,2016-06-28,2016-06-29,6,28,284,1 days,6456056,5780572
514,10515,2,5,Freebam,29-06-2016,Chicago,IL,10,Rockford,IL,07-07-2016,495,403,4591,5339,77,International,7,2016-06-29,2016-07-07,6,29,748,8 days,6461395,5785163
1344,11345,3,1,planetron,29-06-2016,Milwaukee,WI,10,Springfield,IL,09-07-2016,912,295,2422,6866,65,International,3,2016-06-29,2016-07-09,6,29,4444,10 days,6468261,5787585
1013,11014,2,1,Tantax,29-06-2016,Milwaukee,WI,8,Springfield,IL,07-07-2016,1002,350,6122,9643,74,International,1,2016-06-29,2016-07-07,6,29,3521,8 days,6477904,5793707
625,10626,1,6,Tamcan,29-06-2016,Northbrook,IL,2,Naperville,IL,01-07-2016,866,563,3845,4170,98,Domestic,4,2016-06-29,2016-07-01,6,29,325,2 days,6482074,5797552
584,10585,1,8,Plustax,29-06-2016,Monon,IN,2,Lansing,MI,01-07-2016,985,626,7253,7621,51,Domestic,8,2016-06-29,2016-07-01,6,29,368,2 days,6489695,5804805
964,10965,2,2,Vaiazoom,29-06-2016,Bangor,MI,1,Davenport,IA,30-06-2016,468,370,3083,4016,99,Domestic,9,2016-06-29,2016-06-30,6,29,933,1 days,6493711,5807888
532,10533,2,7,Siliconcore,29-06-2016,Davenport,IA,10,Appleton,WI,06-07-2016,590,348,2354,3040,50,International,4,2016-06-29,2016-07-06,6,29,686,7 days,6496751,5810242
1793,11794,3,4,Conzumzap,29-06-2016,Appleton,WI,2,Grand Rapids,MI,01-07-2016,1139,358,4116,1848,72,Domestic,9,2016-06-29,2016-07-01,6,29,-2268,2 days,6498599,5814358
1475,11476,2,2,Donware,29-06-2016,Davenport,IA,9,Appleton,WI,11-07-2016,382,303,7949,8200,72,International,7,2016-06-29,2016-07-11,6,29,251,12 days,6506799,5822307
1003,11004,2,6,apzone,29-06-2016,Appleton,WI,8,Grand Rapids,MI,06-07-2016,845,554,6464,6733,100,International,6,2016-06-29,2016-07-06,6,29,269,7 days,6513532,5828771
195,10196,2,7,Golddexon,29-06-2016,Rockford,IL,6,Green Bay,WI,05-07-2016,845,503,3701,4343,81,International,1,2016-06-29,2016-07-05,6,29,642,6 days,6517875,5832472
1076,11077,3,3,Alphadax,29-06-2016,Grand Rapids,MI,2,Toledo,OH,30-06-2016,772,647,2506,2750,69,Domestic,3,2016-06-29,2016-06-30,6,29,244,1 days,6520625,5834978
980,10981,2,5,Fin-cone,29-06-2016,Naperville,IL,10,Indianapolis,IN,09-07-2016,782,304,1321,1915,60,International,4,2016-06-29,2016-07-09,6,29,594,10 days,6522540,5836299
474,10475,2,6,Planetware,30-06-2016,Detriot,MI,2,Monon,IN,02-07-2016,1130,543,7377,7559,55,Intercom,9,2016-06-30,2016-07-02,6,30,182,2 days,6530099,5843676
783,10784,2,7,D-quadlux,30-06-2016,Green Bay,WI,1,Joliet,IL,01-07-2016,515,515,8162,8796,50,Domestic,7,2016-06-30,2016-07-01,6,30,634,1 days,6538895,5851838
1164,11165,2,5,Warebam,30-06-2016,Kalamazoo,MI,2,Bangor,MI,02-07-2016,357,253,2510,3480,80,Intercom,6,2016-06-30,2016-07-02,6,30,970,2 days,6542375,5854348
1783,11784,2,4,Quotelane,30-06-2016,Chicago,IL,7,Rockford,IL,07-07-2016,646,571,5485,3641,81,International,4,2016-06-30,2016-07-07,6,30,-1844,7 days,6546016,5859833
165,10166,2,5,Daltcare,30-06-2016,Grand Rapids,MI,9,Toledo,OH,09-07-2016,365,365,4892,5431,58,International,1,2016-06-30,2016-07-09,6,30,539,9 days,6551447,5864725
1613,11614,3,6,Laex,30-06-2016,Joliet,IL,4,Madison,WI,06-07-2016,661,661,5750,6438,50,Domestic,4,2016-06-30,2016-07-06,6,30,688,6 days,6557885,5870475
256,10257,2,7,Vivazim,30-06-2016,Madison,WI,5,Kalamazoo,MI,02-07-2016,564,423,7029,7151,63,International,2,2016-06-30,2016-07-02,6,30,122,2 days,6565036,5877504
732,10733,2,8,Ronvivalam,01-07-2016,Springfield,IL,6,Skokie,IL,06-07-2016,917,769,4670,4994,63,International,8,2016-07-01,2016-07-06,7,1,324,5 days,6570030,5882174
1226,11227,3,1,Sonlex,01-07-2016,Cincinnati,OH,8,Gary,IN,08-07-2016,830,647,340,5818,58,International,10,2016-07-01,2016-07-08,7,1,5478,7 days,6575848,5882514
1426,11427,3,2,Donremlane,01-07-2016,Bangor,MI,9,Davenport,IA,08-07-2016,362,362,2412,2938,78,International,10,2016-07-01,2016-07-08,7,1,526,7 days,6578786,5884926
1370,11371,3,6,Ganzsannix,01-07-2016,Chicago,IL,1,Rockford,IL,02-07-2016,941,218,3534,4135,91,Domestic,6,2016-07-01,2016-07-02,7,1,601,1 days,6582921,5888460
248,10249,1,8,Condexon,01-07-2016,Milwaukee,WI,5,Springfield,IL,06-07-2016,759,217,5365,5716,89,International,6,2016-07-01,2016-07-06,7,1,351,5 days,6588637,5893825
1236,11237,3,1,Zuntexon,01-07-2016,Springfield,IL,10,Skokie,IL,11-07-2016,916,592,1880,6531,87,International,5,2016-07-01,2016-07-11,7,1,4651,10 days,6595168,5895705
1307,11308,2,2,Silverace,01-07-2016,Monon,IN,8,Lansing,MI,09-07-2016,641,327,8055,8231,63,International,10,2016-07-01,2016-07-09,7,1,176,8 days,6603399,5903760
366,10367,2,4,Vaiataxon,01-07-2016,Naperville,IL,2,Indianapolis,IN,02-07-2016,654,534,7133,4666,75,Domestic,1,2016-07-01,2016-07-02,7,1,-2467,1 days,6608065,5910893
1474,11475,2,5,Canace,01-07-2016,Kalamazoo,MI,10,Bangor,MI,13-07-2016,324,324,1552,1871,59,International,10,2016-07-01,2016-07-13,7,1,319,12 days,6609936,5912445
865,10866,2,6,Coneranron,01-07-2016,Indianapolis,IN,4,Northbrook,IL,05-07-2016,685,568,4627,5322,68,Domestic,5,2016-07-01,2016-07-05,7,1,695,4 days,6615258,5917072
850,10851,1,2,betaity,02-07-2016,Naperville,IL,2,Indianapolis,IN,03-07-2016,823,501,7050,7512,90,Domestic,4,2016-07-02,2016-07-03,7,2,462,1 days,6622770,5924122
1209,11210,3,6,Baselux,02-07-2016,Skokie,IL,4,Chicago,IL,06-07-2016,1069,416,5128,5454,68,Domestic,1,2016-07-02,2016-07-06,7,2,326,4 days,6628224,5929250
610,10611,2,4,Lazap,02-07-2016,Naperville,IL,3,Indianapolis,IN,05-07-2016,254,246,7021,4690,71,Domestic,7,2016-07-02,2016-07-05,7,2,-2331,3 days,6632914,5936271
1516,11517,3,6,Solholdings,02-07-2016,Bangor,MI,4,Davenport,IA,06-07-2016,694,331,533,831,89,Domestic,2,2016-07-02,2016-07-06,7,2,298,4 days,6633745,5936804
87,10088,1,8,Beta-ron,02-07-2016,Monon,IN,3,Lansing,MI,05-07-2016,1096,455,4658,5505,59,Domestic,6,2016-07-02,2016-07-05,7,2,847,3 days,6639250,5941462
1358,11359,3,1,Scotline,02-07-2016,Cincinnati,OH,2,Gary,IN,04-07-2016,515,410,4994,9200,97,Domestic,9,2016-07-02,2016-07-04,7,2,4206,2 days,6648450,5946456
849,10850,2,2,Canphase,02-07-2016,Green Bay,WI,4,Joliet,IL,06-07-2016,1180,446,4920,5256,86,Domestic,3,2016-07-02,2016-07-06,7,2,336,4 days,6653706,5951376
640,10641,2,8,Sanlab,02-07-2016,Skokie,IL,3,Chicago,IL,05-07-2016,432,432,6030,6871,65,Domestic,8,2016-07-02,2016-07-05,7,2,841,3 days,6660577,5957406
794,10795,1,5,Runhigh,02-07-2016,Grand Rapids,MI,2,Toledo,OH,02-07-2016,243,243,146,709,96,Domestic,5,2016-07-02,2016-07-02,7,2,563,0 days,6661286,5957552
740,10741,2,5,Y-zoom,03-07-2016,Naperville,IL,4,Indianapolis,IN,05-07-2016,1086,305,6114,6737,95,Domestic,1,2016-07-03,2016-07-05,7,3,623,2 days,6668023,5963666
1288,11289,3,6,Aptaxon,03-07-2016,Naperville,IL,4,Indianapolis,IN,05-07-2016,778,635,3995,4340,100,Domestic,1,2016-07-03,2016-07-05,7,3,345,2 days,6672363,5967661
1734,11735,2,4,Dongbase,03-07-2016,Milwaukee,WI,1,Springfield,IL,04-07-2016,598,598,2915,1119,71,Domestic,2,2016-07-03,2016-07-04,7,3,-1796,1 days,6673482,5970576
1505,11506,2,3,Villacom,03-07-2016,Joliet,IL,2,Madison,WI,06-07-2016,1102,771,1598,2131,59,Domestic,8,2016-07-03,2016-07-06,7,3,533,3 days,6675613,5972174
1233,11234,3,3,xx-bam,03-07-2016,Davenport,IA,4,Appleton,WI,07-07-2016,424,424,3026,3502,57,Domestic,2,2016-07-03,2016-07-07,7,3,476,4 days,6679115,5975200
274,10275,2,7,Gogokeying,03-07-2016,Indianapolis,IN,2,Northbrook,IL,05-07-2016,570,570,2144,2467,89,Domestic,2,2016-07-03,2016-07-05,7,3,323,2 days,6681582,5977344
527,10528,2,5,Warecity,03-07-2016,Lansing,MI,2,Dayton,OH,05-07-2016,623,382,2149,2646,56,Intercom,10,2016-07-03,2016-07-05,7,3,497,2 days,6684228,5979493
133,10134,1,6,Bluezoombam,04-07-2016,Naperville,IL,3,Indianapolis,IN,07-07-2016,759,265,6313,6958,57,Domestic,3,2016-07-04,2016-07-07,7,4,645,3 days,6691186,5985806
723,10724,1,5,Joyancom,04-07-2016,Appleton,WI,2,Grand Rapids,MI,06-07-2016,762,740,7962,8395,89,Domestic,7,2016-07-04,2016-07-06,7,4,433,2 days,6699581,5993768
1665,11666,2,4,Ganzsannix,04-07-2016,Bangor,MI,1,Davenport,IA,05-07-2016,379,379,2629,658,93,Domestic,4,2016-07-04,2016-07-05,7,4,-1971,1 days,6700239,5996397
1379,11380,2,3,Toncode,04-07-2016,Rockford,IL,1,Green Bay,WI,05-07-2016,893,296,6035,7025,79,Domestic,1,2016-07-04,2016-07-05,7,4,990,1 days,6707264,6002432
1279,11280,3,4,bluecorporation,04-07-2016,Chicago,IL,10,Rockford,IL,13-07-2016,1181,472,4557,2875,67,International,6,2016-07-04,2016-07-13,7,4,-1682,9 days,6710139,6006989
479,10480,1,5,conestreet,04-07-2016,Naperville,IL,2,Indianapolis,IN,05-07-2016,913,733,884,1319,83,Domestic,3,2016-07-04,2016-07-05,7,4,435,1 days,6711458,6007873
176,10177,2,4,Planetware,04-07-2016,Appleton,WI,4,Grand Rapids,MI,08-07-2016,937,227,5530,3445,66,Domestic,5,2016-07-04,2016-07-08,7,4,-2085,4 days,6714903,6013403
1123,11124,3,1,Donremlane,04-07-2016,Chicago,IL,5,Rockford,IL,09-07-2016,1057,216,6694,11259,52,International,8,2016-07-04,2016-07-09,7,4,4565,5 days,6726162,6020097
44,10045,2,6,Bamtechnology,04-07-2016,Indianapolis,IN,8,Northbrook,IL,12-07-2016,1170,729,7183,7517,78,International,2,2016-07-04,2016-07-12,7,4,334,8 days,6733679,6027280
607,10608,1,7,zotit,05-07-2016,Monon,IN,2,Lansing,MI,07-07-2016,1013,396,3311,3733,67,Domestic,1,2016-07-05,2016-07-07,7,5,422,2 days,6737412,6030591
1668,11669,3,1,Planetware,05-07-2016,Kalamazoo,MI,3,Bangor,MI,08-07-2016,572,324,8229,13250,62,Domestic,5,2016-07-05,2016-07-08,7,5,5021,3 days,6750662,6038820
1221,11222,3,3,Canemedkix,05-07-2016,Monon,IN,5,Lansing,MI,21-03-2016,723,212,7485,7773,91,International,2,2016-07-05,2016-03-21,7,5,288,-106 days,6758435,6046305
497,10498,1,5,white-high,05-07-2016,Monon,IN,4,Lansing,MI,09-07-2016,464,464,4584,5553,89,Domestic,3,2016-07-05,2016-07-09,7,5,969,4 days,6763988,6050889
1244,11245,2,2,Unoex,05-07-2016,Green Bay,WI,9,Joliet,IL,12-07-2016,1173,719,3740,3881,65,International,3,2016-07-05,2016-07-12,7,5,141,7 days,6767869,6054629
953,10954,3,5,nimlab,06-07-2016,Indianapolis,IN,4,Northbrook,IL,08-07-2016,977,350,3367,4081,57,Domestic,1,2016-07-06,2016-07-08,7,6,714,2 days,6771950,6057996
218,10219,1,5,Linezatlam,06-07-2016,Appleton,WI,2,Grand Rapids,MI,08-07-2016,481,481,1637,1770,50,Intercom,5,2016-07-06,2016-07-08,7,6,133,2 days,6773720,6059633
1448,11449,2,4,Roundlam,06-07-2016,Lansing,MI,2,Dayton,OH,08-07-2016,863,243,2643,769,53,Domestic,6,2016-07-06,2016-07-08,7,6,-1874,2 days,6774489,6062276
1479,11480,3,6,Kinice,06-07-2016,Indianapolis,IN,4,Northbrook,IL,10-07-2016,1191,540,2912,3656,51,Domestic,1,2016-07-06,2016-07-10,7,6,744,4 days,6778145,6065188
341,10342,2,6,Greentech,06-07-2016,Joliet,IL,7,Madison,WI,13-07-2016,464,275,1344,1676,100,International,9,2016-07-06,2016-07-13,7,6,332,7 days,6779821,6066532
1372,11373,2,5,Planetline,06-07-2016,Northbrook,IL,1,Naperville,IL,07-07-2016,476,462,335,718,83,Domestic,2,2016-07-06,2016-07-07,7,6,383,1 days,6780539,6066867
945,10946,2,5,silfase,07-07-2016,Lansing,MI,7,Dayton,OH,14-07-2016,856,791,761,1338,90,International,7,2016-07-07,2016-07-14,7,7,577,7 days,6781877,6067628
1804,11805,3,5,scotquote,07-07-2016,Springfield,IL,1,Skokie,IL,08-07-2016,824,432,7605,8441,99,Intercom,9,2016-07-07,2016-07-08,7,7,836,1 days,6790318,6075233
20,10021,2,6,K-is,07-07-2016,Davenport,IA,2,Appleton,WI,09-07-2016,874,325,539,1226,82,Domestic,9,2016-07-07,2016-07-09,7,7,687,2 days,6791544,6075772
372,10373,1,8,Condintex,07-07-2016,Lansing,MI,2,Dayton,OH,09-07-2016,1178,243,4585,4756,94,Domestic,10,2016-07-07,2016-07-09,7,7,171,2 days,6796300,6080357
806,10807,1,6,re-can,07-07-2016,Appleton,WI,4,Grand Rapids,MI,11-07-2016,248,248,1197,2015,85,Domestic,2,2016-07-07,2016-07-11,7,7,818,4 days,6798315,6081554
1653,11654,2,2,Fixace,07-07-2016,Indianapolis,IN,2,Northbrook,IL,07-07-2016,957,690,7558,8319,52,Domestic,8,2016-07-07,2016-07-07,7,7,761,0 days,6806634,6089112
488,10489,1,8,wareholding,07-07-2016,Skokie,IL,9,Chicago,IL,16-07-2016,937,229,6171,6411,99,International,7,2016-07-07,2016-07-16,7,7,240,9 days,6813045,6095283
537,10538,1,5,Danfan,08-07-2016,Indianapolis,IN,2,Northbrook,IL,10-07-2016,513,513,1238,1492,81,Domestic,7,2016-07-08,2016-07-10,7,8,254,2 days,6814537,6096521
1667,11668,3,5,Planetline,08-07-2016,Skokie,IL,2,Chicago,IL,10-07-2016,805,240,8322,8425,92,Domestic,9,2016-07-08,2016-07-10,7,8,103,2 days,6822962,6104843
554,10555,1,8,Vivazim,08-07-2016,Springfield,IL,4,Skokie,IL,12-07-2016,232,232,3400,3731,63,Domestic,2,2016-07-08,2016-07-12,7,8,331,4 days,6826693,6108243
230,10231,1,6,Streetlam,08-07-2016,Northbrook,IL,6,Naperville,IL,14-07-2016,394,390,1961,2173,71,International,6,2016-07-08,2016-07-14,7,8,212,6 days,6828866,6110204
1425,11426,3,6,Warecity,08-07-2016,Lansing,MI,7,Dayton,OH,14-07-2016,537,442,2745,3674,68,International,4,2016-07-08,2016-07-14,7,8,929,6 days,6832540,6112949
495,10496,1,8,Inchholdings,08-07-2016,Gary,IN,6,Milwaukee,WI,13-07-2016,222,222,2737,3501,89,International,3,2016-07-08,2016-07-13,7,8,764,5 days,6836041,6115686
963,10964,2,2,geofind,08-07-2016,Toledo,OH,6,Detriot,MI,21-03-2016,700,220,5178,5534,94,International,6,2016-07-08,2016-03-21,7,8,356,-109 days,6841575,6120864
0,10001,1,5,Reddoit,08-07-2016,Grand Rapids,MI,3,Toledo,OH,09-07-2016,955,687,2232,2910,99,Domestic,9,2016-07-08,2016-07-09,7,8,678,1 days,6844485,6123096
1247,11248,2,3,Anmedia,08-07-2016,Appleton,WI,3,Grand Rapids,MI,11-07-2016,895,559,5870,6432,98,Domestic,8,2016-07-08,2016-07-11,7,8,562,3 days,6850917,6128966
1278,11279,3,1,Zentrax,08-07-2016,Springfield,IL,10,Skokie,IL,17-07-2016,593,593,79,5294,61,International,8,2016-07-08,2016-07-17,7,8,5215,9 days,6856211,6129045
1346,11347,3,4,Zuntone,08-07-2016,Chicago,IL,10,Rockford,IL,18-07-2016,451,202,7933,6142,97,International,1,2016-07-08,2016-07-18,7,8,-1791,10 days,6862353,6136978
1413,11414,3,2,Faxzumtrax,09-07-2016,Indianapolis,IN,3,Northbrook,IL,12-07-2016,1135,746,3783,3951,56,Domestic,8,2016-07-09,2016-07-12,7,9,168,3 days,6866304,6140761
604,10605,2,5,Keyzunbase,09-07-2016,Detriot,MI,8,Monon,IN,15-07-2016,535,442,4501,4725,66,International,3,2016-07-09,2016-07-15,7,9,224,6 days,6871029,6145262
1080,11081,2,3,Funlatlex,09-07-2016,Indianapolis,IN,1,Northbrook,IL,10-07-2016,1062,770,3521,3808,76,Domestic,9,2016-07-09,2016-07-10,7,9,287,1 days,6874837,6148783
808,10809,1,8,acequote,09-07-2016,Dayton,OH,3,Elgin,IL,12-07-2016,803,443,1841,2434,87,Domestic,2,2016-07-09,2016-07-12,7,9,593,3 days,6877271,6150624
1213,11214,3,6,Planethouse,09-07-2016,Milwaukee,WI,3,Springfield,IL,12-07-2016,728,728,223,857,50,Domestic,8,2016-07-09,2016-07-12,7,9,634,3 days,6878128,6150847
219,10220,1,6,O-ace,09-07-2016,Cincinnati,OH,3,Gary,IN,12-07-2016,660,454,8330,8910,68,Domestic,4,2016-07-09,2016-07-12,7,9,580,3 days,6887038,6159177
98,10099,1,4,Aptaxon,09-07-2016,Elgin,IL,3,Cincinnati,OH,12-07-2016,425,425,4752,3175,53,Domestic,6,2016-07-09,2016-07-12,7,9,-1577,3 days,6890213,6163929
1250,11251,2,1,Kincorporation,10-07-2016,Toledo,OH,2,Detriot,MI,12-07-2016,541,541,184,4259,99,Domestic,10,2016-07-10,2016-07-12,7,10,4075,2 days,6894472,6164113
1179,11180,3,5,Bamgeohigh,10-07-2016,Rockford,IL,6,Green Bay,WI,16-07-2016,601,274,8130,8769,55,International,10,2016-07-10,2016-07-16,7,10,639,6 days,6903241,6172243
1759,11760,3,5,openzap,10-07-2016,Springfield,IL,4,Skokie,IL,14-07-2016,1101,222,8324,8800,75,Domestic,2,2016-07-10,2016-07-14,7,10,476,4 days,6912041,6180567
971,10972,3,6,Xx-canex,10-07-2016,Chicago,IL,1,Rockford,IL,11-07-2016,1012,355,2732,3227,99,Domestic,3,2016-07-10,2016-07-11,7,10,495,1 days,6915268,6183299
1756,11757,3,6,Itcantrans,11-07-2016,Davenport,IA,4,Appleton,WI,15-07-2016,499,499,5954,6468,79,Domestic,2,2016-07-11,2016-07-15,7,11,514,4 days,6921736,6189253
317,10318,2,4,Cannamcon,11-07-2016,Indianapolis,IN,2,Northbrook,IL,13-07-2016,864,674,5245,3337,91,Domestic,7,2016-07-11,2016-07-13,7,11,-1908,2 days,6925073,6194498
1716,11717,2,1,Subvivais,11-07-2016,Indianapolis,IN,1,Northbrook,IL,11-07-2016,819,318,7438,12100,75,Domestic,10,2016-07-11,2016-07-11,7,11,4662,0 days,6937173,6201936
972,10973,2,3,Itdom,11-07-2016,Indianapolis,IN,4,Northbrook,IL,15-07-2016,248,248,6704,7373,100,Domestic,6,2016-07-11,2016-07-15,7,11,669,4 days,6944546,6208640
1079,11080,2,2,D-quadlux,11-07-2016,Chicago,IL,4,Rockford,IL,15-07-2016,1007,475,2885,3670,75,Domestic,6,2016-07-11,2016-07-15,7,11,785,4 days,6948216,6211525
559,10560,1,4,Itcantrans,11-07-2016,Gary,IN,9,Milwaukee,WI,20-07-2016,778,485,3123,545,54,International,10,2016-07-11,2016-07-20,7,11,-2578,9 days,6948761,6214648
1546,11547,3,2,silfase,11-07-2016,Springfield,IL,1,Skokie,IL,12-07-2016,971,446,8538,8867,80,Domestic,2,2016-07-11,2016-07-12,7,11,329,1 days,6957628,6223186
1776,11777,2,3,Kinice,11-07-2016,Elgin,IL,4,Cincinnati,OH,15-07-2016,981,394,5115,5566,84,Domestic,4,2016-07-11,2016-07-15,7,11,451,4 days,6963194,6228301
307,10308,1,7,zotit,11-07-2016,Toledo,OH,6,Detriot,MI,21-03-2016,523,295,2795,3290,53,International,7,2016-07-11,2016-03-21,7,11,495,-112 days,6966484,6231096
500,10501,1,7,hexzim,11-07-2016,Rockford,IL,3,Green Bay,WI,14-07-2016,963,301,6063,6946,80,Domestic,8,2016-07-11,2016-07-14,7,11,883,3 days,6973430,6237159
881,10882,2,1,Bamgeohigh,11-07-2016,Skokie,IL,4,Chicago,IL,15-07-2016,968,560,5665,9800,97,Domestic,8,2016-07-11,2016-07-15,7,11,4135,4 days,6983230,6242824
1394,11395,2,3,Inchholdings,11-07-2016,Gary,IN,4,Milwaukee,WI,15-07-2016,525,525,6453,7245,89,Domestic,7,2016-07-11,2016-07-15,7,11,792,4 days,6990475,6249277
602,10603,1,5,Ganjazone,11-07-2016,Indianapolis,IN,3,Northbrook,IL,14-07-2016,880,256,1605,2359,74,Domestic,3,2016-07-11,2016-07-14,7,11,754,3 days,6992834,6250882
979,10980,2,1,bluecorporation,11-07-2016,Green Bay,WI,8,Joliet,IL,19-07-2016,1108,346,3672,7984,51,International,3,2016-07-11,2016-07-19,7,11,4312,8 days,7000818,6254554
1240,11241,3,3,Tamholding,12-07-2016,Gary,IN,2,Milwaukee,WI,14-07-2016,1035,331,8,608,63,Domestic,2,2016-07-12,2016-07-14,7,12,600,2 days,7001426,6254562
1254,11255,3,6,Faseway,12-07-2016,Grand Rapids,MI,6,Toledo,OH,18-07-2016,1160,724,6086,7020,89,International,3,2016-07-12,2016-07-18,7,12,934,6 days,7008446,6260648
755,10756,1,5,unaity,12-07-2016,Detriot,MI,1,Monon,IN,13-07-2016,1003,387,2806,3070,86,Domestic,7,2016-07-12,2016-07-13,7,12,264,1 days,7011516,6263454
1149,11150,2,6,Canex,12-07-2016,Gary,IN,10,Milwaukee,WI,20-07-2016,376,376,4676,4798,90,International,4,2016-07-12,2016-07-20,7,12,122,8 days,7016314,6268130
652,10653,1,5,Kincorporation,12-07-2016,Monon,IN,10,Lansing,MI,22-07-2016,308,286,6050,6688,59,International,1,2016-07-12,2016-07-22,7,12,638,10 days,7023002,6274180
1196,11197,2,6,ontotam,12-07-2016,Gary,IN,1,Milwaukee,WI,13-07-2016,1151,566,6591,7330,85,Domestic,2,2016-07-12,2016-07-13,7,12,739,1 days,7030332,6280771
580,10581,2,7,Bamgeohigh,12-07-2016,Northbrook,IL,8,Naperville,IL,21-03-2016,794,575,1438,1569,61,International,9,2016-07-12,2016-03-21,7,12,131,-113 days,7031901,6282209
1741,11742,3,3,una-phase,12-07-2016,Joliet,IL,2,Madison,WI,13-07-2016,427,427,208,421,67,Domestic,6,2016-07-12,2016-07-13,7,12,213,1 days,7032322,6282417
1060,11061,2,3,geohigh,12-07-2016,Northbrook,IL,1,Naperville,IL,13-07-2016,567,567,6665,6952,85,Domestic,7,2016-07-12,2016-07-13,7,12,287,1 days,7039274,6289082
1442,11443,3,6,Zimex,13-07-2016,Naperville,IL,3,Indianapolis,IN,16-07-2016,959,776,8277,8417,69,Domestic,5,2016-07-13,2016-07-16,7,13,140,3 days,7047691,6297359
1567,11568,3,1,J-lax,13-07-2016,Grand Rapids,MI,2,Toledo,OH,14-07-2016,818,553,31,5144,97,Domestic,2,2016-07-13,2016-07-14,7,13,5113,1 days,7052835,6297390
297,10298,1,5,Conzumzap,13-07-2016,Detriot,MI,4,Monon,IN,17-07-2016,869,762,3164,4100,58,Domestic,8,2016-07-13,2016-07-17,7,13,936,4 days,7056935,6300554
1333,11334,3,1,Hexunobam,13-07-2016,Appleton,WI,10,Grand Rapids,MI,22-07-2016,377,343,1621,6885,56,International,9,2016-07-13,2016-07-22,7,13,5264,9 days,7063820,6302175
1385,11386,2,4,D-quadlux,13-07-2016,Bangor,MI,7,Davenport,IA,20-07-2016,261,261,4385,1991,61,International,5,2016-07-13,2016-07-20,7,13,-2394,7 days,7065811,6306560
586,10587,1,7,Quotelane,13-07-2016,Green Bay,WI,6,Joliet,IL,17-07-2016,311,311,5252,5579,87,International,8,2016-07-13,2016-07-17,7,13,327,4 days,7071390,6311812
1508,11509,2,1,Stimmedia,13-07-2016,Green Bay,WI,1,Joliet,IL,14-07-2016,866,342,7709,12448,73,Domestic,3,2016-07-13,2016-07-14,7,13,4739,1 days,7083838,6319521
181,10182,2,7,conestreet,13-07-2016,Elgin,IL,9,Cincinnati,OH,22-07-2016,819,503,4528,5311,67,International,10,2016-07-13,2016-07-22,7,13,783,9 days,7089149,6324049
1754,11755,3,5,saltlab,13-07-2016,Skokie,IL,3,Chicago,IL,16-07-2016,409,409,5071,5662,83,Domestic,9,2016-07-13,2016-07-16,7,13,591,3 days,7094811,6329120
562,10563,2,6,openzap,14-07-2016,Madison,WI,1,Kalamazoo,MI,15-07-2016,753,281,5241,5558,79,Intercom,7,2016-07-14,2016-07-15,7,14,317,1 days,7100369,6334361
1316,11317,2,2,Solohex,14-07-2016,Lansing,MI,10,Dayton,OH,23-07-2016,826,383,2440,2745,100,International,10,2016-07-14,2016-07-23,7,14,305,9 days,7103114,6336801
791,10792,2,4,Solozap,14-07-2016,Elgin,IL,3,Cincinnati,OH,17-07-2016,248,248,3504,1449,79,Domestic,8,2016-07-14,2016-07-17,7,14,-2055,3 days,7104563,6340305
1522,11523,3,1,Canemedkix,15-07-2016,Milwaukee,WI,3,Springfield,IL,18-07-2016,632,511,1351,5049,98,Domestic,5,2016-07-15,2016-07-18,7,15,3698,3 days,7109612,6341656
455,10456,1,8,Inzone,15-07-2016,Madison,WI,2,Kalamazoo,MI,17-07-2016,1017,221,8562,8875,85,Intercom,3,2016-07-15,2016-07-17,7,15,313,2 days,7118487,6350218
352,10353,2,6,Blueit,15-07-2016,Kalamazoo,MI,2,Bangor,MI,17-07-2016,720,579,5267,5849,98,Domestic,10,2016-07-15,2016-07-17,7,15,582,2 days,7124336,6355485
1510,11511,3,6,Baselux,15-07-2016,Rockford,IL,8,Green Bay,WI,24-07-2016,793,793,1636,2475,51,International,5,2016-07-15,2016-07-24,7,15,839,9 days,7126811,6357121
862,10863,2,3,Unahigh,15-07-2016,Milwaukee,WI,2,Springfield,IL,17-07-2016,796,286,2817,3254,54,Domestic,7,2016-07-15,2016-07-17,7,15,437,2 days,7130065,6359938
384,10385,1,4,Trueplus,15-07-2016,Detriot,MI,7,Monon,IN,20-07-2016,835,497,4623,2604,98,International,10,2016-07-15,2016-07-20,7,15,-2019,5 days,7132669,6364561
1112,11113,3,3,O-ace,16-07-2016,Cincinnati,OH,10,Gary,IN,23-07-2016,334,334,8424,8724,87,International,4,2016-07-16,2016-07-23,7,16,300,7 days,7141393,6372985
692,10693,1,8,Strongtechnology,16-07-2016,Northbrook,IL,6,Naperville,IL,21-03-2016,400,400,873,1000,87,International,5,2016-07-16,2016-03-21,7,16,127,-117 days,7142393,6373858
1187,11188,3,5,Silverfase,16-07-2016,Skokie,IL,2,Chicago,IL,18-07-2016,1038,791,3986,4781,89,Domestic,3,2016-07-16,2016-07-18,7,16,795,2 days,7147174,6377844
857,10858,2,2,citydexon,17-07-2016,Bangor,MI,4,Davenport,IA,21-07-2016,225,217,4648,4915,87,Domestic,9,2016-07-17,2016-07-21,7,17,267,4 days,7152089,6382492
31,10032,2,6,Zerfax,17-07-2016,Rockford,IL,2,Green Bay,WI,19-07-2016,1102,446,4355,4911,79,Domestic,8,2016-07-17,2016-07-19,7,17,556,2 days,7157000,6386847
1752,11753,2,5,citydexon,17-07-2016,Bangor,MI,5,Davenport,IA,20-07-2016,594,594,8331,8621,74,International,2,2016-07-17,2016-07-20,7,17,290,3 days,7165621,6395178
665,10666,2,8,Dongbiolex,17-07-2016,Davenport,IA,1,Appleton,WI,18-07-2016,863,305,4503,4869,70,Domestic,3,2016-07-17,2016-07-18,7,17,366,1 days,7170490,6399681
1224,11225,2,3,Tamcan,17-07-2016,Rockford,IL,4,Green Bay,WI,21-07-2016,650,432,2038,2182,94,Domestic,8,2016-07-17,2016-07-21,7,17,144,4 days,7172672,6401719
1445,11446,2,6,Silver-line,18-07-2016,Cincinnati,OH,10,Gary,IN,26-07-2016,497,209,1199,2084,56,International,4,2016-07-18,2016-07-26,7,18,885,8 days,7174756,6402918
1068,11069,3,6,Indigoice,18-07-2016,Cincinnati,OH,10,Gary,IN,28-07-2016,288,231,1210,1383,91,International,6,2016-07-18,2016-07-28,7,18,173,10 days,7176139,6404128
1790,11791,2,2,Indi-dox,18-07-2016,Green Bay,WI,7,Joliet,IL,24-07-2016,950,681,8035,8618,58,International,2,2016-07-18,2016-07-24,7,18,583,6 days,7184757,6412163
1276,11277,2,3,Saozoomtex,18-07-2016,Davenport,IA,2,Appleton,WI,20-07-2016,330,330,5438,6118,65,Domestic,1,2016-07-18,2016-07-20,7,18,680,2 days,7190875,6417601
1684,11685,3,2,Isdexon,18-07-2016,Lansing,MI,4,Dayton,OH,22-07-2016,205,205,4327,5066,90,Domestic,8,2016-07-18,2016-07-22,7,18,739,4 days,7195941,6421928
241,10242,1,7,Konknix,18-07-2016,Dayton,OH,2,Elgin,IL,19-07-2016,432,359,6187,6387,67,Domestic,8,2016-07-18,2016-07-19,7,18,200,1 days,7202328,6428115
630,10631,1,5,Saohow,18-07-2016,Madison,WI,4,Kalamazoo,MI,22-07-2016,1186,373,3198,3451,84,Domestic,10,2016-07-18,2016-07-22,7,18,253,4 days,7205779,6431313
1172,11173,2,4,Canace,18-07-2016,Detriot,MI,1,Monon,IN,19-07-2016,965,738,5122,3080,84,Domestic,3,2016-07-18,2016-07-19,7,18,-2042,1 days,7208859,6436435
1219,11220,3,3,applanet,18-07-2016,Gary,IN,8,Milwaukee,WI,26-07-2016,729,632,5087,5418,70,International,7,2016-07-18,2016-07-26,7,18,331,8 days,7214277,6441522
1304,11305,2,3,apzone,18-07-2016,Detriot,MI,2,Monon,IN,20-07-2016,551,551,7634,8467,89,Domestic,8,2016-07-18,2016-07-20,7,18,833,2 days,7222744,6449156
380,10381,1,7,Zentrax,18-07-2016,Springfield,IL,2,Skokie,IL,20-07-2016,456,456,5626,6117,68,Intercom,7,2016-07-18,2016-07-20,7,18,491,2 days,7228861,6454782
609,10610,2,8,Stimmedia,19-07-2016,Green Bay,WI,4,Joliet,IL,23-07-2016,373,366,4644,5437,70,Domestic,2,2016-07-19,2016-07-23,7,19,793,4 days,7234298,6459426
1779,11780,3,5,Latcore,19-07-2016,Davenport,IA,4,Appleton,WI,23-07-2016,804,418,4568,5110,67,Domestic,7,2016-07-19,2016-07-23,7,19,542,4 days,7239408,6463994
1801,11802,2,4,Keyzunbase,19-07-2016,Kalamazoo,MI,7,Bangor,MI,26-07-2016,208,208,4491,2730,50,International,1,2016-07-19,2016-07-26,7,19,-1761,7 days,7242138,6468485
452,10453,2,8,zummatax,19-07-2016,Gary,IN,8,Milwaukee,WI,27-07-2016,516,516,5616,6376,57,International,6,2016-07-19,2016-07-27,7,19,760,8 days,7248514,6474101
904,10905,1,2,hottaxon,19-07-2016,Skokie,IL,3,Chicago,IL,22-07-2016,411,411,2111,2480,91,Domestic,4,2016-07-19,2016-07-22,7,19,369,3 days,7250994,6476212
950,10951,3,6,Physcone,19-07-2016,Grand Rapids,MI,4,Toledo,OH,23-07-2016,398,398,3372,3952,53,Domestic,6,2016-07-19,2016-07-23,7,19,580,4 days,7254946,6479584
568,10569,2,7,Hayholding,20-07-2016,Dayton,OH,4,Elgin,IL,22-07-2016,922,572,4539,5393,65,Domestic,1,2016-07-20,2016-07-22,7,20,854,2 days,7260339,6484123
439,10440,1,6,Quadplanet,20-07-2016,Cincinnati,OH,3,Gary,IN,23-07-2016,453,453,183,311,75,Domestic,8,2016-07-20,2016-07-23,7,20,128,3 days,7260650,6484306
1336,11337,2,1,Carekix,20-07-2016,Toledo,OH,1,Detriot,MI,21-07-2016,588,588,7195,11688,100,Domestic,7,2016-07-20,2016-07-21,7,20,4493,1 days,7272338,6491501
802,10803,2,7,Plexlamway,20-07-2016,Joliet,IL,3,Madison,WI,23-07-2016,565,331,7529,7948,94,Domestic,5,2016-07-20,2016-07-23,7,20,419,3 days,7280286,6499030
659,10660,2,7,Tripplekix,20-07-2016,Toledo,OH,3,Detriot,MI,23-07-2016,261,261,787,1736,69,Domestic,4,2016-07-20,2016-07-23,7,20,949,3 days,7282022,6499817
1277,11278,2,4,Beta-ron,20-07-2016,Milwaukee,WI,2,Springfield,IL,22-07-2016,1157,749,7325,5082,99,Domestic,4,2016-07-20,2016-07-22,7,20,-2243,2 days,7287104,6507142
540,10541,2,4,Dongbase,20-07-2016,Monon,IN,10,Lansing,MI,30-07-2016,1057,384,8798,6619,76,International,3,2016-07-20,2016-07-30,7,20,-2179,10 days,7293723,6515940
1568,11569,2,6,geofind,20-07-2016,Milwaukee,WI,8,Springfield,IL,29-07-2016,1134,370,7101,7894,53,International,8,2016-07-20,2016-07-29,7,20,793,9 days,7301617,6523041
158,10159,2,8,zummatax,20-07-2016,Cincinnati,OH,4,Gary,IN,24-07-2016,1055,717,1236,2015,84,Domestic,1,2016-07-20,2016-07-24,7,20,779,4 days,7303632,6524277
1765,11766,3,1,Hayholding,21-07-2016,Joliet,IL,6,Madison,WI,27-07-2016,337,337,3637,8945,81,International,1,2016-07-21,2016-07-27,7,21,5308,6 days,7312577,6527914
1724,11725,3,6,Tonsanhigh,21-07-2016,Appleton,WI,6,Grand Rapids,MI,27-07-2016,899,534,4657,5596,55,International,7,2016-07-21,2016-07-27,7,21,939,6 days,7318173,6532571
277,10278,1,7,Linetone,22-07-2016,Joliet,IL,4,Madison,WI,24-07-2016,545,545,2051,2503,98,Domestic,5,2016-07-22,2016-07-24,7,22,452,2 days,7320676,6534622
189,10190,2,4,Funlatlex,22-07-2016,Indianapolis,IN,1,Northbrook,IL,22-07-2016,797,400,8741,6735,88,Domestic,8,2016-07-22,2016-07-22,7,22,-2006,0 days,7327411,6543363
899,10900,1,2,Trio-dax,22-07-2016,Dayton,OH,2,Elgin,IL,23-07-2016,881,760,680,874,86,Domestic,3,2016-07-22,2016-07-23,7,22,194,1 days,7328285,6544043
471,10472,1,6,Ganzsannix,22-07-2016,Chicago,IL,9,Rockford,IL,31-07-2016,1179,286,2184,2331,57,International,6,2016-07-22,2016-07-31,7,22,147,9 days,7330616,6546227
1418,11419,2,2,Zunzone,22-07-2016,Monon,IN,7,Lansing,MI,29-07-2016,629,629,5889,6210,59,International,8,2016-07-22,2016-07-29,7,22,321,7 days,7336826,6552116
425,10426,1,7,Goodquoing,22-07-2016,Milwaukee,WI,4,Springfield,IL,26-07-2016,1128,489,1700,2330,78,Domestic,2,2016-07-22,2016-07-26,7,22,630,4 days,7339156,6553816
1045,11046,3,2,Labdox,23-07-2016,Rockford,IL,2,Green Bay,WI,25-07-2016,1158,331,2994,3649,74,Domestic,10,2016-07-23,2016-07-25,7,23,655,2 days,7342805,6556810
1496,11497,2,6,Conzumzap,23-07-2016,Kalamazoo,MI,2,Bangor,MI,25-07-2016,1042,602,7718,8144,54,Intercom,10,2016-07-23,2016-07-25,7,23,426,2 days,7350949,6564528
1317,11318,2,4,Zapline,23-07-2016,Bangor,MI,9,Davenport,IA,29-07-2016,714,334,4466,3417,92,International,3,2016-07-23,2016-07-29,7,23,-1049,6 days,7354366,6568994
324,10325,2,8,Tamcan,23-07-2016,Rockford,IL,8,Green Bay,WI,21-03-2016,208,208,7446,7858,85,International,9,2016-07-23,2016-03-21,7,23,412,-124 days,7362224,6576440
27,10028,2,8,Planethouse,23-07-2016,Monon,IN,9,Lansing,MI,21-03-2016,1012,641,8065,8603,81,International,2,2016-07-23,2016-03-21,7,23,538,-124 days,7370827,6584505
55,10056,2,6,Goldenbam,24-07-2016,Toledo,OH,4,Detriot,MI,28-07-2016,336,336,559,1143,64,Domestic,9,2016-07-24,2016-07-28,7,24,584,4 days,7371970,6585064
1545,11546,2,6,Greentech,24-07-2016,Grand Rapids,MI,3,Toledo,OH,30-07-2016,522,215,2996,3351,50,Domestic,6,2016-07-24,2016-07-30,7,24,355,6 days,7375321,6588060
1573,11574,3,2,Singleholdings,24-07-2016,Gary,IN,4,Milwaukee,WI,28-07-2016,296,296,656,1251,94,Domestic,5,2016-07-24,2016-07-28,7,24,595,4 days,7376572,6588716
1519,11520,3,4,Technoline,24-07-2016,Kalamazoo,MI,10,Bangor,MI,02-08-2016,1036,614,4448,2491,64,International,10,2016-07-24,2016-08-02,7,24,-1957,9 days,7379063,6593164
978,10979,2,1,Zentrax,24-07-2016,Madison,WI,7,Kalamazoo,MI,31-07-2016,595,595,6378,10381,58,International,4,2016-07-24,2016-07-31,7,24,4003,7 days,7389444,6599542
7,10008,1,6,xx-way,24-07-2016,Joliet,IL,3,Madison,WI,26-07-2016,286,286,3968,4654,88,Domestic,4,2016-07-24,2016-07-26,7,24,686,2 days,7394098,6603510
1574,11575,3,3,Gravetech,24-07-2016,Joliet,IL,4,Madison,WI,28-07-2016,262,262,7457,8065,90,Domestic,9,2016-07-24,2016-07-28,7,24,608,4 days,7402163,6610967
1551,11552,2,2,Daltfax,24-07-2016,Gary,IN,6,Milwaukee,WI,02-08-2016,437,437,6525,6742,78,International,9,2016-07-24,2016-08-02,7,24,217,9 days,7408905,6617492
1229,11230,2,5,Yearlex,24-07-2016,Bangor,MI,4,Davenport,IA,28-07-2016,926,377,3872,4215,77,Domestic,2,2016-07-24,2016-07-28,7,24,343,4 days,7413120,6621364
263,10264,1,6,Unahigh,24-07-2016,Toledo,OH,4,Detriot,MI,28-07-2016,654,585,4033,4336,92,Domestic,10,2016-07-24,2016-07-28,7,24,303,4 days,7417456,6625397
1056,11057,2,5,doubleis,24-07-2016,Milwaukee,WI,2,Springfield,IL,26-07-2016,876,433,124,398,90,Domestic,3,2016-07-24,2016-07-26,7,24,274,2 days,7417854,6625521
1329,11330,3,2,Ronvivalam,24-07-2016,Madison,WI,1,Kalamazoo,MI,25-07-2016,814,679,4965,5717,60,Intercom,6,2016-07-24,2016-07-25,7,24,752,1 days,7423571,6630486
309,10310,2,5,Lazap,25-07-2016,Elgin,IL,1,Cincinnati,OH,26-07-2016,630,266,980,1403,57,Domestic,10,2016-07-25,2016-07-26,7,25,423,1 days,7424974,6631466
1239,11240,3,6,Mathing,25-07-2016,Detriot,MI,1,Monon,IN,26-07-2016,876,539,1015,1131,93,Intercom,5,2016-07-25,2016-07-26,7,25,116,1 days,7426105,6632481
1066,11067,3,3,Yearcorporation,25-07-2016,Naperville,IL,2,Indianapolis,IN,26-07-2016,644,557,549,698,64,Domestic,2,2016-07-25,2016-07-26,7,25,149,1 days,7426803,6633030
1633,11634,3,6,Warelane,25-07-2016,Northbrook,IL,1,Naperville,IL,26-07-2016,436,401,1798,2533,97,Domestic,5,2016-07-25,2016-07-26,7,25,735,1 days,7429336,6634828
1775,11776,3,2,Iselectrics,25-07-2016,Bangor,MI,2,Davenport,IA,27-07-2016,451,319,7199,8147,74,Domestic,3,2016-07-25,2016-07-27,7,25,948,2 days,7437483,6642027
961,10962,2,3,Dongbiolex,25-07-2016,Cincinnati,OH,10,Gary,IN,04-08-2016,923,798,2418,2967,95,International,6,2016-07-25,2016-08-04,7,25,549,10 days,7440450,6644445
558,10559,1,4,Conehotice,25-07-2016,Detriot,MI,5,Monon,IN,30-07-2016,272,272,7066,4453,78,International,8,2016-07-25,2016-07-30,7,25,-2613,5 days,7444903,6651511
1498,11499,3,6,Trio-dax,25-07-2016,Grand Rapids,MI,1,Toledo,OH,26-07-2016,844,231,8219,8344,80,Domestic,10,2016-07-25,2016-07-26,7,25,125,1 days,7453247,6659730
276,10277,1,4,Canace,25-07-2016,Detriot,MI,10,Monon,IN,01-08-2016,725,622,5011,3002,88,International,10,2016-07-25,2016-08-01,7,25,-2009,7 days,7456249,6664741
1198,11199,2,5,Ventocore,25-07-2016,Monon,IN,10,Lansing,MI,04-08-2016,788,440,2236,2730,93,International,7,2016-07-25,2016-08-04,7,25,494,10 days,7458979,6666977
147,10148,1,7,Singlejob,25-07-2016,Chicago,IL,8,Rockford,IL,02-08-2016,1160,564,7265,7854,85,International,9,2016-07-25,2016-08-02,7,25,589,8 days,7466833,6674242
551,10552,1,6,Canex,26-07-2016,Davenport,IA,1,Appleton,WI,27-07-2016,1052,800,7652,8381,55,Domestic,5,2016-07-26,2016-07-27,7,26,729,1 days,7475214,6681894
781,10782,2,8,Citytone,26-07-2016,Monon,IN,10,Lansing,MI,21-03-2016,843,707,5230,5828,84,International,4,2016-07-26,2016-03-21,7,26,598,-127 days,7481042,6687124
1143,11144,2,5,una-phase,26-07-2016,Grand Rapids,MI,8,Toledo,OH,03-08-2016,778,336,2653,3073,51,International,2,2016-07-26,2016-08-03,7,26,420,8 days,7484115,6689777
229,10230,1,5,Ganzlane,26-07-2016,Indianapolis,IN,4,Northbrook,IL,28-07-2016,758,681,2995,3970,62,Domestic,3,2016-07-26,2016-07-28,7,26,975,2 days,7488085,6692772
992,10993,3,6,K-antex,27-07-2016,Springfield,IL,1,Skokie,IL,28-07-2016,555,555,5038,5936,75,Domestic,3,2016-07-27,2016-07-28,7,27,898,1 days,7494021,6697810
447,10448,1,8,planetron,27-07-2016,Milwaukee,WI,2,Springfield,IL,29-07-2016,362,328,7043,7694,53,Domestic,3,2016-07-27,2016-07-29,7,27,651,2 days,7501715,6704853
1368,11369,2,6,Zumcane,27-07-2016,Milwaukee,WI,8,Springfield,IL,21-03-2016,1027,658,2574,3114,66,International,1,2016-07-27,2016-03-21,7,27,540,-128 days,7504829,6707427
1234,11235,2,1,Zaamhouse,27-07-2016,Grand Rapids,MI,4,Toledo,OH,29-07-2016,1005,634,3279,7376,88,Domestic,7,2016-07-27,2016-07-29,7,27,4097,2 days,7512205,6710706
689,10690,2,7,Ronlamice,27-07-2016,Springfield,IL,6,Skokie,IL,02-08-2016,643,328,1019,1222,55,International,10,2016-07-27,2016-08-02,7,27,203,6 days,7513427,6711725
145,10146,1,8,Carekix,27-07-2016,Milwaukee,WI,9,Springfield,IL,05-08-2016,981,679,7743,8705,79,International,2,2016-07-27,2016-08-05,7,27,962,9 days,7522132,6719468
41,10042,1,5,Matdex,27-07-2016,Milwaukee,WI,10,Springfield,IL,06-08-2016,219,219,802,1184,59,International,7,2016-07-27,2016-08-06,7,27,382,10 days,7523316,6720270
350,10351,1,8,Vaiazozice,27-07-2016,Lansing,MI,4,Dayton,OH,31-07-2016,1098,626,542,1458,69,Domestic,6,2016-07-27,2016-07-31,7,27,916,4 days,7524774,6720812
1535,11536,3,6,Instrip,27-07-2016,Appleton,WI,1,Grand Rapids,MI,28-07-2016,432,421,5925,6335,56,Intercom,7,2016-07-27,2016-07-28,7,27,410,1 days,7531109,6726737
1452,11453,3,2,O-tom,28-07-2016,Kalamazoo,MI,2,Bangor,MI,30-07-2016,480,335,2124,2634,61,Domestic,2,2016-07-28,2016-07-30,7,28,510,2 days,7533743,6728861
1352,11353,3,5,Keystreet,28-07-2016,Monon,IN,1,Lansing,MI,29-07-2016,1163,323,2142,2262,64,Domestic,3,2016-07-28,2016-07-29,7,28,120,1 days,7536005,6731003
751,10752,1,5,Keystreet,28-07-2016,Milwaukee,WI,2,Springfield,IL,30-07-2016,1139,248,890,1316,100,Domestic,10,2016-07-28,2016-07-30,7,28,426,2 days,7537321,6731893
1192,11193,3,3,Dentocity,28-07-2016,Springfield,IL,3,Skokie,IL,31-07-2016,1042,756,8072,8700,64,Domestic,3,2016-07-28,2016-07-31,7,28,628,3 days,7546021,6739965
578,10579,2,7,Iselectrics,28-07-2016,Chicago,IL,9,Rockford,IL,06-08-2016,630,214,3269,3558,63,International,10,2016-07-28,2016-08-06,7,28,289,9 days,7549579,6743234
645,10646,1,7,silfase,28-07-2016,Springfield,IL,3,Skokie,IL,31-07-2016,989,385,4723,5448,94,Domestic,10,2016-07-28,2016-07-31,7,28,725,3 days,7555027,6747957
1263,11264,3,4,Iceelectrics,28-07-2016,Madison,WI,3,Kalamazoo,MI,31-07-2016,236,236,4329,2938,65,Domestic,6,2016-07-28,2016-07-31,7,28,-1391,3 days,7557965,6752286
29,10030,2,5,Solholdings,28-07-2016,Green Bay,WI,1,Joliet,IL,29-07-2016,751,751,7247,7877,55,Domestic,5,2016-07-28,2016-07-29,7,28,630,1 days,7565842,6759533
615,10616,1,5,Overtam,29-07-2016,Lansing,MI,10,Dayton,OH,08-08-2016,887,580,682,1348,86,International,4,2016-07-29,2016-08-08,7,29,666,10 days,7567190,6760215
1800,11801,2,4,hottaxon,29-07-2016,Skokie,IL,5,Chicago,IL,03-08-2016,429,216,6711,5593,58,International,2,2016-07-29,2016-08-03,7,29,-1118,5 days,7572783,6766926
930,10931,2,2,Groovestrip,29-07-2016,Grand Rapids,MI,5,Toledo,OH,03-08-2016,475,475,1606,1727,83,International,5,2016-07-29,2016-08-03,7,29,121,5 days,7574510,6768532
1006,11007,3,5,Conelane,29-07-2016,Lansing,MI,3,Dayton,OH,01-08-2016,1105,367,5615,6171,68,Domestic,9,2016-07-29,2016-08-01,7,29,556,3 days,7580681,6774147
1022,11023,3,2,Fasetech,29-07-2016,Madison,WI,10,Kalamazoo,MI,07-08-2016,1030,232,3444,4380,56,International,4,2016-07-29,2016-08-07,7,29,936,9 days,7585061,6777591
1019,11020,3,1,Goodtechno,29-07-2016,Gary,IN,2,Milwaukee,WI,31-07-2016,888,263,4566,9263,58,Domestic,2,2016-07-29,2016-07-31,7,29,4697,2 days,7594324,6782157
462,10463,1,8,doubleis,29-07-2016,Toledo,OH,4,Detriot,MI,02-08-2016,876,357,3740,4523,62,Domestic,7,2016-07-29,2016-08-02,7,29,783,4 days,7598847,6785897
1124,11125,3,5,Ganzlane,30-07-2016,Indianapolis,IN,8,Northbrook,IL,07-08-2016,645,645,6897,7373,63,International,10,2016-07-30,2016-08-07,7,30,476,8 days,7606220,6792794
198,10199,1,5,Runhigh,30-07-2016,Dayton,OH,6,Elgin,IL,05-08-2016,1124,459,4067,4191,60,International,4,2016-07-30,2016-08-05,7,30,124,6 days,7610411,6796861
1402,11403,3,2,Good-find,30-07-2016,Cincinnati,OH,10,Gary,IN,09-08-2016,863,564,5607,6519,90,International,3,2016-07-30,2016-08-09,7,30,912,10 days,7616930,6802468
795,10796,1,5,white-high,30-07-2016,Milwaukee,WI,7,Springfield,IL,06-08-2016,202,202,5835,6626,88,International,6,2016-07-30,2016-08-06,7,30,791,7 days,7623556,6808303
166,10167,2,8,doubleis,31-07-2016,Milwaukee,WI,10,Springfield,IL,21-03-2016,422,422,2300,2928,57,International,7,2016-07-31,2016-03-21,7,31,628,-132 days,7626484,6810603
1745,11746,3,6,betaity,31-07-2016,Naperville,IL,9,Indianapolis,IN,09-08-2016,736,515,4108,4495,78,International,7,2016-07-31,2016-08-09,7,31,387,9 days,7630979,6814711
136,10137,2,6,Treedrill,31-07-2016,Cincinnati,OH,10,Gary,IN,09-08-2016,660,570,2773,3203,100,International,4,2016-07-31,2016-08-09,7,31,430,9 days,7634182,6817484
591,10592,2,6,xx-way,31-07-2016,Dayton,OH,2,Elgin,IL,02-08-2016,946,623,3805,4071,74,Domestic,9,2016-07-31,2016-08-02,7,31,266,2 days,7638253,6821289
1089,11090,3,6,Zunhouse,31-07-2016,Appleton,WI,1,Grand Rapids,MI,01-08-2016,708,209,4931,5606,97,Intercom,6,2016-07-31,2016-08-01,7,31,675,1 days,7643859,6826220
359,10360,2,6,mathtouch,31-07-2016,Northbrook,IL,8,Naperville,IL,21-03-2016,283,274,3047,3871,53,International,6,2016-07-31,2016-03-21,7,31,824,-132 days,7647730,6829267
1526,11527,2,5,Tamcan,31-07-2016,Northbrook,IL,2,Naperville,IL,02-08-2016,336,254,5420,5630,71,Domestic,2,2016-07-31,2016-08-02,7,31,210,2 days,7653360,6834687
403,10404,2,8,Duoflex,01-08-2016,Milwaukee,WI,3,Springfield,IL,04-08-2016,511,511,3856,4319,66,Domestic,9,2016-08-01,2016-08-04,8,1,463,3 days,7657679,6838543
399,10400,1,5,Dripvivadex,01-08-2016,Skokie,IL,5,Chicago,IL,21-03-2016,386,386,6259,6443,53,International,5,2016-08-01,2016-03-21,8,1,184,-133 days,7664122,6844802
1345,11346,3,1,Stimcore,01-08-2016,Springfield,IL,5,Skokie,IL,06-08-2016,320,320,4291,8506,88,International,8,2016-08-01,2016-08-06,8,1,4215,5 days,7672628,6849093
634,10635,2,7,Instrip,01-08-2016,Appleton,WI,10,Grand Rapids,MI,11-08-2016,420,407,4568,5475,58,International,4,2016-08-01,2016-08-11,8,1,907,10 days,7678103,6853661
690,10691,1,8,Zummatexon,01-08-2016,Chicago,IL,8,Rockford,IL,09-08-2016,369,320,5754,6350,82,International,1,2016-08-01,2016-08-09,8,1,596,8 days,7684453,6859415
921,10922,3,2,Technoline,01-08-2016,Appleton,WI,4,Grand Rapids,MI,05-08-2016,504,504,7032,7647,75,Domestic,1,2016-08-01,2016-08-05,8,1,615,4 days,7692100,6866447
214,10215,2,6,ganz-is,01-08-2016,Monon,IN,6,Lansing,MI,07-08-2016,723,715,8510,8882,65,International,7,2016-08-01,2016-08-07,8,1,372,6 days,7700982,6874957
1738,11739,2,3,Saocity,01-08-2016,Northbrook,IL,2,Naperville,IL,03-08-2016,537,537,1971,2449,61,Domestic,8,2016-08-01,2016-08-03,8,1,478,2 days,7703431,6876928
239,10240,1,8,Truebam,01-08-2016,Appleton,WI,8,Grand Rapids,MI,07-08-2016,529,529,7025,7700,71,International,5,2016-08-01,2016-08-07,8,1,675,6 days,7711131,6883953
531,10532,2,8,Tonsanhigh,02-08-2016,Kalamazoo,MI,8,Bangor,MI,09-08-2016,1168,466,2611,3458,57,International,1,2016-08-02,2016-08-09,8,2,847,7 days,7714589,6886564
826,10827,1,8,Ganzlane,02-08-2016,Naperville,IL,3,Indianapolis,IN,05-08-2016,1187,624,659,1092,55,Domestic,4,2016-08-02,2016-08-05,8,2,433,3 days,7715681,6887223
1419,11420,3,6,hat-core,02-08-2016,Madison,WI,9,Kalamazoo,MI,11-08-2016,611,242,1402,2266,71,International,10,2016-08-02,2016-08-11,8,2,864,9 days,7717947,6888625
1178,11179,3,4,Kinice,02-08-2016,Naperville,IL,2,Indianapolis,IN,03-08-2016,250,250,4551,2397,62,Domestic,3,2016-08-02,2016-08-03,8,2,-2154,1 days,7720344,6893176
822,10823,1,4,Icedox,02-08-2016,Joliet,IL,2,Madison,WI,03-08-2016,538,538,5738,3541,84,Domestic,3,2016-08-02,2016-08-03,8,2,-2197,1 days,7723885,6898914
511,10512,1,7,acequote,02-08-2016,Grand Rapids,MI,1,Toledo,OH,03-08-2016,749,739,3584,4156,84,Domestic,9,2016-08-02,2016-08-03,8,2,572,1 days,7728041,6902498
349,10350,1,8,Physcone,02-08-2016,Dayton,OH,2,Elgin,IL,02-08-2016,661,661,5769,6347,95,Domestic,9,2016-08-02,2016-08-02,8,2,578,0 days,7734388,6908267
1605,11606,2,3,apzone,03-08-2016,Kalamazoo,MI,2,Bangor,MI,05-08-2016,630,513,4557,5076,92,Intercom,2,2016-08-03,2016-08-05,8,3,519,2 days,7739464,6912824
381,10382,1,4,bluecorporation,03-08-2016,Chicago,IL,4,Rockford,IL,07-08-2016,842,644,5379,2953,57,Domestic,4,2016-08-03,2016-08-07,8,3,-2426,4 days,7742417,6918203
594,10595,2,5,Damdexon,03-08-2016,Elgin,IL,2,Cincinnati,OH,04-08-2016,470,470,7335,7703,87,Domestic,6,2016-08-03,2016-08-04,8,3,368,1 days,7750120,6925538
1433,11434,2,5,Daltron,03-08-2016,Springfield,IL,4,Skokie,IL,07-08-2016,946,461,324,807,96,Domestic,9,2016-08-03,2016-08-07,8,3,483,4 days,7750927,6925862
676,10677,1,6,Itdom,03-08-2016,Naperville,IL,4,Indianapolis,IN,07-08-2016,339,339,4701,5433,66,Domestic,4,2016-08-03,2016-08-07,8,3,732,4 days,7756360,6930563
1674,11675,3,1,Toncode,03-08-2016,Northbrook,IL,7,Naperville,IL,21-03-2016,692,632,2556,7395,88,International,6,2016-08-03,2016-03-21,8,3,4839,-135 days,7763755,6933119
1016,11017,2,4,Tamtexon,04-08-2016,Indianapolis,IN,5,Northbrook,IL,09-08-2016,1071,582,3805,1179,70,International,10,2016-08-04,2016-08-09,8,4,-2626,5 days,7764934,6936924
928,10929,2,1,Tamcan,04-08-2016,Skokie,IL,9,Chicago,IL,13-08-2016,203,203,1910,5785,60,International,5,2016-08-04,2016-08-13,8,4,3875,9 days,7770719,6938834
254,10255,1,7,Canex,04-08-2016,Gary,IN,2,Milwaukee,WI,06-08-2016,384,235,6799,7607,52,Domestic,1,2016-08-04,2016-08-06,8,4,808,2 days,7778326,6945633
1806,11807,2,2,Baselux,04-08-2016,Northbrook,IL,1,Naperville,IL,05-08-2016,1193,433,4390,4974,74,Domestic,6,2016-08-04,2016-08-05,8,4,584,1 days,7783300,6950023
183,10184,1,6,Rankphase,04-08-2016,Kalamazoo,MI,2,Bangor,MI,06-08-2016,1052,440,5470,6318,79,Intercom,10,2016-08-04,2016-08-06,8,4,848,2 days,7789618,6955493
1261,11262,3,4,J-lax,04-08-2016,Joliet,IL,3,Madison,WI,05-08-2016,651,555,5600,4118,73,Domestic,10,2016-08-04,2016-08-05,8,4,-1482,1 days,7793736,6961093
1739,11740,2,1,Joyzim,04-08-2016,Detriot,MI,4,Monon,IN,08-08-2016,647,647,3483,8106,55,Domestic,5,2016-08-04,2016-08-08,8,4,4623,4 days,7801842,6964576
583,10584,1,6,Reddoit,04-08-2016,Joliet,IL,1,Madison,WI,05-08-2016,1163,498,7125,7611,70,Domestic,8,2016-08-04,2016-08-05,8,4,486,1 days,7809453,6971701
854,10855,1,3,villahouse,05-08-2016,Dayton,OH,6,Elgin,IL,11-08-2016,742,434,6376,7001,93,International,2,2016-08-05,2016-08-11,8,5,625,6 days,7816454,6978077
656,10657,1,4,tamplex,05-08-2016,Rockford,IL,10,Green Bay,WI,21-03-2016,496,496,4112,1789,89,International,2,2016-08-05,2016-03-21,8,5,-2323,-137 days,7818243,6982189
419,10420,1,6,Solohex,05-08-2016,Lansing,MI,1,Dayton,OH,06-08-2016,326,326,7461,7932,65,Intercom,8,2016-08-05,2016-08-06,8,5,471,1 days,7826175,6989650
1159,11160,2,2,Unahigh,05-08-2016,Toledo,OH,5,Detriot,MI,10-08-2016,555,280,5461,5932,87,International,10,2016-08-05,2016-08-10,8,5,471,5 days,7832107,6995111
184,10185,1,4,Gravemedia,05-08-2016,Davenport,IA,1,Appleton,WI,06-08-2016,972,594,5874,3607,55,Domestic,5,2016-08-05,2016-08-06,8,5,-2267,1 days,7835714,7000985
871,10872,1,4,Zamlane,05-08-2016,Madison,WI,7,Kalamazoo,MI,12-08-2016,238,238,5288,3463,68,International,10,2016-08-05,2016-08-12,8,5,-1825,7 days,7839177,7006273
756,10757,2,4,Scotline,05-08-2016,Gary,IN,4,Milwaukee,WI,09-08-2016,735,587,7613,5673,89,Domestic,6,2016-08-05,2016-08-09,8,5,-1940,4 days,7844850,7013886
824,10825,1,5,Warecity,05-08-2016,Madison,WI,1,Kalamazoo,MI,06-08-2016,385,302,440,1027,67,Domestic,1,2016-08-05,2016-08-06,8,5,587,1 days,7845877,7014326
1540,11541,2,5,Howplanet,05-08-2016,Bangor,MI,10,Davenport,IA,12-08-2016,707,563,4916,5161,64,International,4,2016-08-05,2016-08-12,8,5,245,7 days,7851038,7019242
1091,11092,3,6,Runhigh,05-08-2016,Dayton,OH,3,Elgin,IL,08-08-2016,675,481,3831,4536,87,Domestic,1,2016-08-05,2016-08-08,8,5,705,3 days,7855574,7023073
283,10284,1,6,Reddoit,05-08-2016,Dayton,OH,3,Elgin,IL,05-08-2016,800,466,3263,3866,68,Domestic,8,2016-08-05,2016-08-05,8,5,603,0 days,7859440,7026336
1795,11796,3,4,Trio-dax,06-08-2016,Dayton,OH,3,Elgin,IL,09-08-2016,880,362,6287,4300,50,Domestic,1,2016-08-06,2016-08-09,8,6,-1987,3 days,7863740,7032623
712,10713,1,5,Conelane,06-08-2016,Springfield,IL,2,Skokie,IL,08-08-2016,431,431,7972,8435,54,Intercom,7,2016-08-06,2016-08-08,8,6,463,2 days,7872175,7040595
1761,11762,3,4,Coneranron,06-08-2016,Indianapolis,IN,2,Northbrook,IL,07-08-2016,317,317,2975,1179,84,Domestic,6,2016-08-06,2016-08-07,8,6,-1796,1 days,7873354,7043570
443,10444,1,8,Y-zoom,06-08-2016,Elgin,IL,3,Cincinnati,OH,06-08-2016,255,255,3296,4273,50,Domestic,9,2016-08-06,2016-08-06,8,6,977,0 days,7877627,7046866
1081,11082,2,3,wareholding,06-08-2016,Northbrook,IL,4,Naperville,IL,10-08-2016,514,273,5746,6457,73,Domestic,9,2016-08-06,2016-08-10,8,6,711,4 days,7884084,7052612
1095,11096,3,2,Opebase,06-08-2016,Elgin,IL,3,Cincinnati,OH,06-08-2016,434,434,5983,6719,89,Domestic,4,2016-08-06,2016-08-06,8,6,736,0 days,7890803,7058595
1274,11275,2,1,Zamholdings,06-08-2016,Skokie,IL,8,Chicago,IL,21-03-2016,700,388,2735,7537,96,International,3,2016-08-06,2016-03-21,8,6,4802,-138 days,7898340,7061330
1160,11161,2,3,openzap,06-08-2016,Lansing,MI,5,Dayton,OH,11-08-2016,333,333,848,1655,100,International,8,2016-08-06,2016-08-11,8,6,807,5 days,7899995,7062178
563,10564,2,7,Redozetam,06-08-2016,Green Bay,WI,3,Joliet,IL,09-08-2016,643,599,1687,2575,63,Domestic,1,2016-08-06,2016-08-09,8,6,888,3 days,7902570,7063865
1053,11054,2,5,unaity,07-08-2016,Kalamazoo,MI,2,Bangor,MI,09-08-2016,598,219,2976,3973,64,Intercom,5,2016-08-07,2016-08-09,8,7,997,2 days,7906543,7066841
398,10399,2,6,Quotefix,07-08-2016,Elgin,IL,10,Cincinnati,OH,17-08-2016,1003,675,6343,6650,72,International,10,2016-08-07,2016-08-17,8,7,307,10 days,7913193,7073184
383,10384,2,7,Ranmedia,07-08-2016,Northbrook,IL,2,Naperville,IL,09-08-2016,435,426,3533,3781,97,Domestic,8,2016-08-07,2016-08-09,8,7,248,2 days,7916974,7076717
1444,11445,2,3,Joyzim,07-08-2016,Appleton,WI,8,Grand Rapids,MI,14-08-2016,1127,255,8372,8859,61,International,6,2016-08-07,2016-08-14,8,7,487,7 days,7925833,7085089
1512,11513,3,3,Fax-ex,07-08-2016,Cincinnati,OH,10,Gary,IN,19-08-2016,1101,738,3996,4351,56,International,4,2016-08-07,2016-08-19,8,7,355,12 days,7930184,7089085
1057,11058,2,1,Ontohatron,07-08-2016,Springfield,IL,8,Skokie,IL,13-08-2016,629,248,4341,8773,97,International,8,2016-08-07,2016-08-13,8,7,4432,6 days,7938957,7093426
1035,11036,3,5,Ozeris,07-08-2016,Springfield,IL,1,Skokie,IL,08-08-2016,1135,614,1519,2168,95,Intercom,8,2016-08-07,2016-08-08,8,7,649,1 days,7941125,7094945
1794,11795,2,6,ontotam,07-08-2016,Cincinnati,OH,1,Gary,IN,08-08-2016,742,417,4909,5540,93,Domestic,7,2016-08-07,2016-08-08,8,7,631,1 days,7946665,7099854
746,10747,2,5,Zuntone,07-08-2016,Bangor,MI,1,Davenport,IA,08-08-2016,1144,470,5718,5883,70,Domestic,3,2016-08-07,2016-08-08,8,7,165,1 days,7952548,7105572
1608,11609,2,1,Silverace,07-08-2016,Milwaukee,WI,3,Springfield,IL,10-08-2016,689,399,2870,7914,65,Domestic,2,2016-08-07,2016-08-10,8,7,5044,3 days,7960462,7108442
152,10153,2,4,planetron,07-08-2016,Monon,IN,1,Lansing,MI,08-08-2016,305,305,3456,2098,86,Domestic,9,2016-08-07,2016-08-08,8,7,-1358,1 days,7962560,7111898
1058,11059,3,6,Indibase,08-08-2016,Chicago,IL,5,Rockford,IL,12-08-2016,712,629,2208,3025,69,International,4,2016-08-08,2016-08-12,8,8,817,4 days,7965585,7114106
1065,11066,2,3,Zerhouse,08-08-2016,Madison,WI,3,Kalamazoo,MI,11-08-2016,842,303,7683,8222,50,Domestic,4,2016-08-08,2016-08-11,8,8,539,3 days,7973807,7121789
988,10989,2,3,Aptaxon,08-08-2016,Elgin,IL,2,Cincinnati,OH,08-08-2016,716,235,5909,6025,66,Domestic,7,2016-08-08,2016-08-08,8,8,116,0 days,7979832,7127698
619,10620,1,5,Technoline,08-08-2016,Kalamazoo,MI,1,Bangor,MI,09-08-2016,840,508,3696,4346,78,Intercom,9,2016-08-08,2016-08-09,8,8,650,1 days,7984178,7131394
1459,11460,3,6,saltlab,08-08-2016,Northbrook,IL,10,Naperville,IL,21-03-2016,209,209,2997,3898,87,International,5,2016-08-08,2016-03-21,8,8,901,-140 days,7988076,7134391
156,10157,1,8,Labdox,08-08-2016,Rockford,IL,2,Green Bay,WI,10-08-2016,760,265,97,738,83,Domestic,7,2016-08-08,2016-08-10,8,8,641,2 days,7988814,7134488
654,10655,2,6,Plusla,08-08-2016,Green Bay,WI,5,Joliet,IL,13-08-2016,308,308,7272,8062,86,International,2,2016-08-08,2016-08-13,8,8,790,5 days,7996876,7141760
1434,11435,2,6,Y-strip,09-08-2016,Chicago,IL,3,Rockford,IL,12-08-2016,720,546,3963,4215,88,Domestic,5,2016-08-09,2016-08-12,8,9,252,3 days,8001091,7145723
473,10474,1,7,Planetline,09-08-2016,Northbrook,IL,9,Naperville,IL,21-03-2016,565,215,5451,6260,90,International,5,2016-08-09,2016-03-21,8,9,809,-141 days,8007351,7151174
1585,11586,3,4,Trueplus,09-08-2016,Kalamazoo,MI,10,Bangor,MI,22-08-2016,225,225,7199,4386,66,International,10,2016-08-09,2016-08-22,8,9,-2813,13 days,8011737,7158373
1558,11559,2,6,roundphase,09-08-2016,Cincinnati,OH,10,Gary,IN,16-08-2016,455,206,6726,7209,65,International,10,2016-08-09,2016-08-16,8,9,483,7 days,8018946,7165099
1214,11215,2,3,Overtam,09-08-2016,Springfield,IL,3,Skokie,IL,12-08-2016,886,682,8667,8920,64,Domestic,6,2016-08-09,2016-08-12,8,9,253,3 days,8027866,7173766
986,10987,2,2,Ronlamice,09-08-2016,Lansing,MI,8,Dayton,OH,14-08-2016,561,372,1123,1813,59,International,10,2016-08-09,2016-08-14,8,9,690,5 days,8029679,7174889
779,10780,2,5,Gravemedia,09-08-2016,Gary,IN,10,Milwaukee,WI,19-08-2016,935,549,1647,2455,59,International,2,2016-08-09,2016-08-19,8,9,808,10 days,8032134,7176536
302,10303,2,6,Ganjazone,09-08-2016,Naperville,IL,3,Indianapolis,IN,09-08-2016,349,349,5287,6043,93,Domestic,10,2016-08-09,2016-08-09,8,9,756,0 days,8038177,7181823
1575,11576,3,4,Condintex,09-08-2016,Madison,WI,5,Kalamazoo,MI,11-08-2016,260,260,6269,4214,73,International,3,2016-08-09,2016-08-11,8,9,-2055,2 days,8042391,7188092
1655,11656,3,2,unaity,09-08-2016,Detriot,MI,6,Monon,IN,15-08-2016,258,258,6009,6165,60,International,8,2016-08-09,2016-08-15,8,9,156,6 days,8048556,7194101
355,10356,1,8,Tripplekix,09-08-2016,Milwaukee,WI,6,Springfield,IL,15-08-2016,208,208,1539,1797,59,International,4,2016-08-09,2016-08-15,8,9,258,6 days,8050353,7195640
1705,11706,2,4,ganz-is,09-08-2016,Toledo,OH,10,Detriot,MI,19-08-2016,518,518,2563,1151,82,International,7,2016-08-09,2016-08-19,8,9,-1412,10 days,8051504,7198203
1064,11065,3,4,Zumcane,09-08-2016,Monon,IN,4,Lansing,MI,13-08-2016,1010,724,6716,4665,61,Domestic,1,2016-08-09,2016-08-13,8,9,-2051,4 days,8056169,7204919
1375,11376,3,2,Zotfan,10-08-2016,Joliet,IL,1,Madison,WI,10-08-2016,1054,732,709,1598,76,Domestic,6,2016-08-10,2016-08-10,8,10,889,0 days,8057767,7205628
650,10651,2,8,Daltfax,10-08-2016,Gary,IN,1,Milwaukee,WI,11-08-2016,1155,257,7583,8379,80,Domestic,6,2016-08-10,2016-08-11,8,10,796,1 days,8066146,7213211
737,10738,2,8,Carekix,10-08-2016,Monon,IN,4,Lansing,MI,14-08-2016,369,339,5430,5752,76,Domestic,8,2016-08-10,2016-08-14,8,10,322,4 days,8071898,7218641
448,10449,1,7,Stimcore,10-08-2016,Springfield,IL,2,Skokie,IL,12-08-2016,308,308,6684,6964,57,Domestic,2,2016-08-10,2016-08-12,8,10,280,2 days,8078862,7225325
517,10518,1,4,O-ace,10-08-2016,Gary,IN,4,Milwaukee,WI,14-08-2016,246,246,3062,1186,66,Domestic,9,2016-08-10,2016-08-14,8,10,-1876,4 days,8080048,7228387
258,10259,2,6,Ittam,10-08-2016,Naperville,IL,3,Indianapolis,IN,10-08-2016,451,310,6043,6957,64,Domestic,4,2016-08-10,2016-08-10,8,10,914,0 days,8087005,7234430
674,10675,2,8,Condintex,10-08-2016,Madison,WI,2,Kalamazoo,MI,12-08-2016,410,410,7434,7686,55,Intercom,9,2016-08-10,2016-08-12,8,10,252,2 days,8094691,7241864
1637,11638,3,5,Carekix,10-08-2016,Monon,IN,8,Lansing,MI,18-08-2016,245,245,6048,6778,67,International,1,2016-08-10,2016-08-18,8,10,730,8 days,8101469,7247912
1117,11118,2,3,Subvivais,10-08-2016,Elgin,IL,3,Cincinnati,OH,13-08-2016,889,502,2718,3258,56,Domestic,5,2016-08-10,2016-08-13,8,10,540,3 days,8104727,7250630
770,10771,1,5,Planetline,11-08-2016,Skokie,IL,1,Chicago,IL,12-08-2016,868,721,2596,3054,73,Domestic,2,2016-08-11,2016-08-12,8,11,458,1 days,8107781,7253226
312,10313,1,7,Fax-ex,11-08-2016,Davenport,IA,5,Appleton,WI,13-08-2016,721,687,2534,3110,93,International,2,2016-08-11,2016-08-13,8,11,576,2 days,8110891,7255760
52,10053,1,6,Sanlab,11-08-2016,Rockford,IL,3,Green Bay,WI,14-08-2016,737,349,777,979,66,Domestic,2,2016-08-11,2016-08-14,8,11,202,3 days,8111870,7256537
1725,11726,3,4,Siliconcore,11-08-2016,Cincinnati,OH,7,Gary,IN,18-08-2016,907,373,7077,5491,70,International,5,2016-08-11,2016-08-18,8,11,-1586,7 days,8117361,7263614
880,10881,1,4,Kinice,11-08-2016,Elgin,IL,4,Cincinnati,OH,12-08-2016,1175,582,4810,3138,51,Domestic,3,2016-08-11,2016-08-12,8,11,-1672,1 days,8120499,7268424
1497,11498,2,5,ontotam,11-08-2016,Davenport,IA,1,Appleton,WI,12-08-2016,715,575,3133,3442,84,Domestic,6,2016-08-11,2016-08-12,8,11,309,1 days,8123941,7271557
1005,11006,3,1,Silverace,11-08-2016,Toledo,OH,2,Detriot,MI,13-08-2016,445,291,760,5789,100,Domestic,9,2016-08-11,2016-08-13,8,11,5029,2 days,8129730,7272317
107,10108,2,7,Trustcorporation,11-08-2016,Detriot,MI,3,Monon,IN,14-08-2016,849,439,7701,8358,97,Domestic,6,2016-08-11,2016-08-14,8,11,657,3 days,8138088,7280018
894,10895,1,6,Indi-dox,11-08-2016,Green Bay,WI,4,Joliet,IL,15-08-2016,751,612,5730,6395,98,Domestic,8,2016-08-11,2016-08-15,8,11,665,4 days,8144483,7285748
1141,11142,3,5,Joyzim,12-08-2016,Kalamazoo,MI,9,Bangor,MI,21-08-2016,376,376,7657,7921,58,International,2,2016-08-12,2016-08-21,8,12,264,9 days,8152404,7293405
146,10147,1,5,Ozeris,12-08-2016,Springfield,IL,5,Skokie,IL,17-08-2016,540,540,2049,2790,74,International,7,2016-08-12,2016-08-17,8,12,741,5 days,8155194,7295454
1607,11608,2,6,Jaylane,13-08-2016,Grand Rapids,MI,3,Toledo,OH,16-08-2016,356,356,375,1240,62,Domestic,8,2016-08-13,2016-08-16,8,13,865,3 days,8156434,7295829
1688,11689,3,1,Inchholdings,13-08-2016,Davenport,IA,6,Appleton,WI,19-08-2016,1033,627,4766,8714,50,International,2,2016-08-13,2016-08-19,8,13,3948,6 days,8165148,7300595
627,10628,1,6,Sonlex,13-08-2016,Gary,IN,1,Milwaukee,WI,14-08-2016,1166,228,8454,8893,78,Domestic,4,2016-08-13,2016-08-14,8,13,439,1 days,8174041,7309049
832,10833,2,8,Daltron,13-08-2016,Lansing,MI,10,Dayton,OH,23-08-2016,668,507,1374,1632,65,International,4,2016-08-13,2016-08-23,8,13,258,10 days,8175673,7310423
299,10300,2,8,Ventocore,13-08-2016,Monon,IN,2,Lansing,MI,15-08-2016,945,481,432,1179,56,Domestic,4,2016-08-13,2016-08-15,8,13,747,2 days,8176852,7310855
149,10150,1,4,Faxron,13-08-2016,Northbrook,IL,7,Naperville,IL,21-03-2016,1146,787,2284,874,98,International,10,2016-08-13,2016-03-21,8,13,-1410,-145 days,8177726,7313139
1388,11389,2,3,Anzammedia,13-08-2016,Kalamazoo,MI,2,Bangor,MI,15-08-2016,835,637,4954,5440,73,Intercom,2,2016-08-13,2016-08-15,8,13,486,2 days,8183166,7318093
1462,11463,3,3,Unahigh,13-08-2016,Monon,IN,3,Lansing,MI,16-08-2016,711,570,7698,8379,53,Domestic,2,2016-08-13,2016-08-16,8,13,681,3 days,8191545,7325791
232,10233,1,7,Siliconcore,13-08-2016,Gary,IN,5,Milwaukee,WI,18-08-2016,313,313,3503,4259,92,International,9,2016-08-13,2016-08-18,8,13,756,5 days,8195804,7329294
1467,11468,2,6,Warebam,14-08-2016,Appleton,WI,2,Grand Rapids,MI,16-08-2016,1086,206,6382,6538,53,Domestic,9,2016-08-14,2016-08-16,8,14,156,2 days,8202342,7335676
135,10136,2,5,Kantone,14-08-2016,Appleton,WI,8,Grand Rapids,MI,21-08-2016,986,654,389,998,57,International,5,2016-08-14,2016-08-21,8,14,609,7 days,8203340,7336065
1267,11268,2,2,Rancan,14-08-2016,Appleton,WI,3,Grand Rapids,MI,17-08-2016,350,350,2521,2880,73,Domestic,8,2016-08-14,2016-08-17,8,14,359,3 days,8206220,7338586
1312,11313,2,2,Plusity,14-08-2016,Appleton,WI,2,Grand Rapids,MI,16-08-2016,350,350,7144,7853,73,Intercom,5,2016-08-14,2016-08-16,8,14,709,2 days,8214073,7345730
1194,11195,2,2,Subdrill,14-08-2016,Northbrook,IL,2,Naperville,IL,16-08-2016,1060,550,1984,2213,96,Domestic,2,2016-08-14,2016-08-16,8,14,229,2 days,8216286,7347714
727,10728,1,5,Flexplex,14-08-2016,Bangor,MI,8,Davenport,IA,22-08-2016,468,294,758,1733,59,International,3,2016-08-14,2016-08-22,8,14,975,8 days,8218019,7348472
82,10083,1,4,Itdom,14-08-2016,Indianapolis,IN,4,Northbrook,IL,16-08-2016,740,684,7126,4937,57,Domestic,9,2016-08-14,2016-08-16,8,14,-2189,2 days,8222956,7355598
1166,11167,2,1,Hayholding,14-08-2016,Grand Rapids,MI,2,Toledo,OH,16-08-2016,265,265,6625,11210,89,Domestic,6,2016-08-14,2016-08-16,8,14,4585,2 days,8234166,7362223
1750,11751,2,5,Tempfan,14-08-2016,Toledo,OH,1,Detriot,MI,15-08-2016,1074,500,5414,5647,76,Domestic,7,2016-08-14,2016-08-15,8,14,233,1 days,8239813,7367637
657,10658,2,6,roundphase,14-08-2016,Cincinnati,OH,2,Gary,IN,16-08-2016,1005,529,6984,7360,81,Domestic,2,2016-08-14,2016-08-16,8,14,376,2 days,8247173,7374621
811,10812,1,8,Freebam,15-08-2016,Bangor,MI,2,Davenport,IA,17-08-2016,1072,489,3762,4056,68,Domestic,7,2016-08-15,2016-08-17,8,15,294,2 days,8251229,7378383
240,10241,1,5,Triootity,15-08-2016,Cincinnati,OH,9,Gary,IN,22-08-2016,942,682,5940,6176,86,International,1,2016-08-15,2016-08-22,8,15,236,7 days,8257405,7384323
648,10649,2,6,Sunjob,15-08-2016,Northbrook,IL,3,Naperville,IL,18-08-2016,1159,778,3648,4557,97,Domestic,10,2016-08-15,2016-08-18,8,15,909,3 days,8261962,7387971
1634,11635,3,2,Hexunobam,15-08-2016,Detriot,MI,4,Monon,IN,19-08-2016,761,327,7035,7205,66,Domestic,1,2016-08-15,2016-08-19,8,15,170,4 days,8269167,7395006
1662,11663,2,1,Goldenlex,15-08-2016,Cincinnati,OH,9,Gary,IN,21-08-2016,825,268,3085,7247,77,International,5,2016-08-15,2016-08-21,8,15,4162,6 days,8276414,7398091
91,10092,2,6,Ranmedia,15-08-2016,Rockford,IL,6,Green Bay,WI,21-08-2016,695,695,2626,2858,93,International,4,2016-08-15,2016-08-21,8,15,232,6 days,8279272,7400717
415,10416,2,8,Plusity,15-08-2016,Appleton,WI,10,Grand Rapids,MI,25-08-2016,393,393,4627,5297,57,International,4,2016-08-15,2016-08-25,8,15,670,10 days,8284569,7405344
898,10899,2,4,ontotam,16-08-2016,Cincinnati,OH,5,Gary,IN,19-08-2016,1065,389,3912,1660,75,International,9,2016-08-16,2016-08-19,8,16,-2252,3 days,8286229,7409256
454,10455,1,8,Keystreet,16-08-2016,Monon,IN,6,Lansing,MI,21-03-2016,353,258,326,678,70,International,3,2016-08-16,2016-03-21,8,16,352,-148 days,8286907,7409582
1744,11745,3,2,Canphase,16-08-2016,Green Bay,WI,5,Joliet,IL,21-08-2016,357,357,1523,1934,56,International,4,2016-08-16,2016-08-21,8,16,411,5 days,8288841,7411105
793,10794,1,4,Inchholdings,16-08-2016,Davenport,IA,4,Appleton,WI,20-08-2016,868,249,7013,4792,82,Domestic,2,2016-08-16,2016-08-20,8,16,-2221,4 days,8293633,7418118
104,10105,2,7,K-antex,16-08-2016,Springfield,IL,1,Skokie,IL,17-08-2016,961,369,104,886,93,Domestic,9,2016-08-16,2016-08-17,8,16,782,1 days,8294519,7418222
493,10494,1,8,Golddexon,16-08-2016,Northbrook,IL,4,Naperville,IL,20-08-2016,1094,619,3359,3686,67,Domestic,8,2016-08-16,2016-08-20,8,16,327,4 days,8298205,7421581
331,10332,2,4,dripkix,16-08-2016,Skokie,IL,1,Chicago,IL,17-08-2016,711,630,3354,1279,96,Domestic,10,2016-08-16,2016-08-17,8,16,-2075,1 days,8299484,7424935
597,10598,2,7,ontotam,17-08-2016,Davenport,IA,5,Appleton,WI,22-08-2016,1036,335,6357,7319,90,International,1,2016-08-17,2016-08-22,8,17,962,5 days,8306803,7431292
946,10947,2,3,Zoodrill,17-08-2016,Elgin,IL,7,Cincinnati,OH,24-08-2016,543,543,2130,2737,75,International,3,2016-08-17,2016-08-24,8,17,607,7 days,8309540,7433422
1266,11267,3,6,Pluslam,17-08-2016,Rockford,IL,1,Green Bay,WI,18-08-2016,562,562,5395,5659,94,Domestic,6,2016-08-17,2016-08-18,8,17,264,1 days,8315199,7438817
1305,11306,2,5,Donglax,17-08-2016,Gary,IN,1,Milwaukee,WI,18-08-2016,296,296,7764,8507,81,Domestic,3,2016-08-17,2016-08-18,8,17,743,1 days,8323706,7446581
494,10495,2,5,Zunhouse,17-08-2016,Detriot,MI,5,Monon,IN,21-08-2016,632,238,3257,3645,80,International,1,2016-08-17,2016-08-21,8,17,388,4 days,8327351,7449838
1465,11466,2,2,Coneranron,17-08-2016,Naperville,IL,1,Indianapolis,IN,17-08-2016,922,545,2504,3018,56,Domestic,8,2016-08-17,2016-08-17,8,17,514,0 days,8330369,7452342
88,10089,1,8,Zentrax,17-08-2016,Madison,WI,2,Kalamazoo,MI,19-08-2016,448,231,6069,6291,73,Domestic,9,2016-08-17,2016-08-19,8,17,222,2 days,8336660,7458411
820,10821,1,8,Joygreen,18-08-2016,Detriot,MI,10,Monon,IN,25-08-2016,738,626,1662,2144,50,International,10,2016-08-18,2016-08-25,8,18,482,7 days,8338804,7460073
110,10111,1,6,Canetechnology,18-08-2016,Madison,WI,5,Kalamazoo,MI,23-08-2016,263,240,2678,3012,78,International,1,2016-08-18,2016-08-23,8,18,334,5 days,8341816,7462751
547,10548,2,7,Canphase,18-08-2016,Bangor,MI,10,Davenport,IA,27-08-2016,578,578,5126,5850,93,International,1,2016-08-18,2016-08-27,8,18,724,9 days,8347666,7467877
616,10617,2,5,Solholdings,18-08-2016,Bangor,MI,10,Davenport,IA,28-08-2016,870,610,5515,5788,57,International,10,2016-08-18,2016-08-28,8,18,273,10 days,8353454,7473392
1037,11038,2,5,Y-zoom,18-08-2016,Indianapolis,IN,2,Northbrook,IL,20-08-2016,296,296,469,1117,73,Domestic,4,2016-08-18,2016-08-20,8,18,648,2 days,8354571,7473861
1729,11730,3,3,Y-strip,18-08-2016,Bangor,MI,2,Davenport,IA,20-08-2016,995,258,6160,6467,59,Domestic,2,2016-08-18,2016-08-20,8,18,307,2 days,8361038,7480021
942,10943,3,1,Mathing,19-08-2016,Appleton,WI,1,Grand Rapids,MI,20-08-2016,1110,497,1259,6156,76,Domestic,5,2016-08-19,2016-08-20,8,19,4897,1 days,8367194,7481280
1220,11221,3,3,Zoncone,19-08-2016,Joliet,IL,5,Madison,WI,24-08-2016,305,305,5533,6501,71,International,1,2016-08-19,2016-08-24,8,19,968,5 days,8373695,7486813
671,10672,1,6,Pluslam,19-08-2016,Northbrook,IL,5,Naperville,IL,24-08-2016,437,437,2642,3461,87,International,4,2016-08-19,2016-08-24,8,19,819,5 days,8377156,7489455
1295,11296,2,5,Dripvivadex,19-08-2016,Skokie,IL,2,Chicago,IL,21-08-2016,516,516,6024,6650,98,Domestic,9,2016-08-19,2016-08-21,8,19,626,2 days,8383806,7495479
1698,11699,2,5,hotity,19-08-2016,Madison,WI,4,Kalamazoo,MI,23-08-2016,527,401,7353,8238,61,Domestic,10,2016-08-19,2016-08-23,8,19,885,4 days,8392044,7502832
1682,11683,2,6,Zoomhex,20-08-2016,Cincinnati,OH,2,Gary,IN,22-08-2016,503,503,5772,6378,52,Domestic,4,2016-08-20,2016-08-22,8,20,606,2 days,8398422,7508604
1453,11454,2,2,Canex,20-08-2016,Davenport,IA,1,Appleton,WI,21-08-2016,253,253,5680,6123,54,Domestic,2,2016-08-20,2016-08-21,8,20,443,1 days,8404545,7514284
388,10389,2,5,Ronlamice,20-08-2016,Madison,WI,1,Kalamazoo,MI,21-08-2016,535,246,6336,6975,57,Domestic,5,2016-08-20,2016-08-21,8,20,639,1 days,8411520,7520620
382,10383,1,8,Fin-cone,20-08-2016,Indianapolis,IN,4,Northbrook,IL,24-08-2016,453,453,2467,3207,62,Domestic,2,2016-08-20,2016-08-24,8,20,740,4 days,8414727,7523087
1680,11681,3,6,wareholding,20-08-2016,Rockford,IL,4,Green Bay,WI,24-08-2016,533,464,8470,8797,72,Domestic,4,2016-08-20,2016-08-24,8,20,327,4 days,8423524,7531557
589,10590,1,8,O-job,20-08-2016,Appleton,WI,3,Grand Rapids,MI,23-08-2016,526,335,2088,2515,67,Domestic,10,2016-08-20,2016-08-23,8,20,427,3 days,8426039,7533645
1595,11596,2,2,Constreet,21-08-2016,Green Bay,WI,3,Joliet,IL,24-08-2016,1192,439,1825,2255,67,Domestic,10,2016-08-21,2016-08-24,8,21,430,3 days,8428294,7535470
1591,11592,3,1,Plextechi,21-08-2016,Detriot,MI,5,Monon,IN,24-08-2016,365,365,7528,12495,79,International,10,2016-08-21,2016-08-24,8,21,4967,3 days,8440789,7542998
121,10122,1,5,Plusity,21-08-2016,Kalamazoo,MI,3,Bangor,MI,24-08-2016,414,414,7683,8396,68,Domestic,9,2016-08-21,2016-08-24,8,21,713,3 days,8449185,7550681
631,10632,1,5,Yearlex,21-08-2016,Green Bay,WI,4,Joliet,IL,25-08-2016,994,290,56,1016,73,Domestic,5,2016-08-21,2016-08-25,8,21,960,4 days,8450201,7550737
948,10949,2,2,Anmedia,22-08-2016,Kalamazoo,MI,2,Bangor,MI,24-08-2016,275,275,23,946,50,Intercom,9,2016-08-22,2016-08-24,8,22,923,2 days,8451147,7550760
1363,11364,2,1,Dongtinlux,22-08-2016,Elgin,IL,4,Cincinnati,OH,25-08-2016,232,232,7040,10695,64,Domestic,2,2016-08-22,2016-08-25,8,22,3655,3 days,8461842,7557800
1258,11259,3,3,mathtouch,22-08-2016,Northbrook,IL,1,Naperville,IL,23-08-2016,856,549,504,1448,71,Domestic,8,2016-08-22,2016-08-23,8,22,944,1 days,8463290,7558304
1193,11194,2,4,Indi-dox,22-08-2016,Chicago,IL,3,Rockford,IL,25-08-2016,515,494,6531,4642,99,Domestic,3,2016-08-22,2016-08-25,8,22,-1889,3 days,8467932,7564835
1325,11326,2,2,Bluezoombam,22-08-2016,Indianapolis,IN,3,Northbrook,IL,23-08-2016,826,245,4796,5106,96,Domestic,3,2016-08-22,2016-08-23,8,22,310,1 days,8473038,7569631
933,10934,2,2,dripkix,22-08-2016,Northbrook,IL,3,Naperville,IL,25-08-2016,420,420,3817,4311,51,Domestic,5,2016-08-22,2016-08-25,8,22,494,3 days,8477349,7573448
776,10777,2,8,Dentoelectrics,22-08-2016,Chicago,IL,4,Rockford,IL,26-08-2016,1020,320,8072,8923,64,Domestic,4,2016-08-22,2016-08-26,8,22,851,4 days,8486272,7581520
268,10269,1,5,Warebam,22-08-2016,Kalamazoo,MI,6,Bangor,MI,28-08-2016,248,248,8142,8817,56,International,10,2016-08-22,2016-08-28,8,22,675,6 days,8495089,7589662
721,10722,2,5,Tamtexon,22-08-2016,Naperville,IL,4,Indianapolis,IN,26-08-2016,552,552,3035,3135,88,Domestic,9,2016-08-22,2016-08-26,8,22,100,4 days,8498224,7592697
1621,11622,3,3,Zunice,22-08-2016,Dayton,OH,5,Elgin,IL,30-08-2016,252,252,2431,2729,94,International,9,2016-08-22,2016-08-30,8,22,298,8 days,8500953,7595128
1190,11191,2,1,xx-way,22-08-2016,Grand Rapids,MI,3,Toledo,OH,23-08-2016,802,207,404,5251,58,Domestic,7,2016-08-22,2016-08-23,8,22,4847,1 days,8506204,7595532
839,10840,1,6,Dongbase,22-08-2016,Milwaukee,WI,4,Springfield,IL,26-08-2016,436,436,3312,3901,68,Domestic,3,2016-08-22,2016-08-26,8,22,589,4 days,8510105,7598844
468,10469,1,5,Canecare,22-08-2016,Grand Rapids,MI,2,Toledo,OH,22-08-2016,1111,570,489,1089,56,Domestic,5,2016-08-22,2016-08-22,8,22,600,0 days,8511194,7599333
1270,11271,3,5,Strongcane,23-08-2016,Toledo,OH,9,Detriot,MI,01-09-2016,357,357,3556,4474,51,International,10,2016-08-23,2016-09-01,8,23,918,9 days,8515668,7602889
251,10252,1,4,betaity,23-08-2016,Indianapolis,IN,6,Northbrook,IL,29-08-2016,411,411,8197,5857,57,International,8,2016-08-23,2016-08-29,8,23,-2340,6 days,8521525,7611086
1107,11108,2,2,Sonbam,23-08-2016,Madison,WI,2,Kalamazoo,MI,25-08-2016,287,287,605,929,94,Intercom,6,2016-08-23,2016-08-25,8,23,324,2 days,8522454,7611691
1034,11035,3,3,Hexunobam,23-08-2016,Kalamazoo,MI,5,Bangor,MI,28-08-2016,302,302,1066,1844,62,International,4,2016-08-23,2016-08-28,8,23,778,5 days,8524298,7612757
1167,11168,2,2,Finlux,23-08-2016,Milwaukee,WI,3,Springfield,IL,26-08-2016,361,361,1740,2342,87,Domestic,3,2016-08-23,2016-08-26,8,23,602,3 days,8526640,7614497
1206,11207,3,6,scotquote,23-08-2016,Lansing,MI,9,Dayton,OH,31-08-2016,320,238,1132,1879,73,International,3,2016-08-23,2016-08-31,8,23,747,8 days,8528519,7615629
588,10589,1,6,Silverfase,23-08-2016,Rockford,IL,3,Green Bay,WI,26-08-2016,1121,410,7092,7492,98,Domestic,10,2016-08-23,2016-08-26,8,23,400,3 days,8536011,7622721
53,10054,2,8,Tamholding,23-08-2016,Cincinnati,OH,4,Gary,IN,27-08-2016,986,264,6554,7325,90,Domestic,7,2016-08-23,2016-08-27,8,23,771,4 days,8543336,7629275
109,10110,2,7,Duoflex,23-08-2016,Monon,IN,10,Lansing,MI,02-09-2016,201,201,2117,3047,70,International,8,2016-08-23,2016-09-02,8,23,930,10 days,8546383,7631392
684,10685,1,6,Ranmedia,23-08-2016,Skokie,IL,1,Chicago,IL,24-08-2016,987,250,3453,3862,97,Domestic,8,2016-08-23,2016-08-24,8,23,409,1 days,8550245,7634845
1156,11157,2,3,Conehotice,23-08-2016,Appleton,WI,2,Grand Rapids,MI,25-08-2016,983,614,5377,6238,72,Domestic,7,2016-08-23,2016-08-25,8,23,861,2 days,8556483,7640222
1455,11456,2,1,Tempfan,24-08-2016,Milwaukee,WI,5,Springfield,IL,29-08-2016,755,366,5721,9906,92,International,2,2016-08-24,2016-08-29,8,24,4185,5 days,8566389,7645943
842,10843,1,7,Zimex,24-08-2016,Indianapolis,IN,3,Northbrook,IL,24-08-2016,523,523,8111,8311,67,Domestic,6,2016-08-24,2016-08-24,8,24,200,0 days,8574700,7654054
1015,11016,2,3,Zapline,24-08-2016,Chicago,IL,6,Rockford,IL,30-08-2016,1088,692,8285,8651,50,International,5,2016-08-24,2016-08-30,8,24,366,6 days,8583351,7662339
1024,11025,3,4,Bluezoombam,24-08-2016,Naperville,IL,3,Indianapolis,IN,26-08-2016,1065,637,6720,4794,91,Domestic,1,2016-08-24,2016-08-26,8,24,-1926,2 days,8588145,7669059
581,10582,1,5,Funfintech,24-08-2016,Detriot,MI,1,Monon,IN,25-08-2016,1095,251,4179,5110,96,Intercom,7,2016-08-24,2016-08-25,8,24,931,1 days,8593255,7673238
542,10543,1,5,Zimex,25-08-2016,Naperville,IL,8,Indianapolis,IN,02-09-2016,859,730,5904,6529,50,International,10,2016-08-25,2016-09-02,8,25,625,8 days,8599784,7679142
95,10096,1,7,Medialax,25-08-2016,Toledo,OH,8,Detriot,MI,21-03-2016,782,563,3742,4572,66,International,5,2016-08-25,2016-03-21,8,25,830,-157 days,8604356,7682884
266,10267,1,6,Coneranron,25-08-2016,Elgin,IL,2,Cincinnati,OH,26-08-2016,781,458,3069,4045,58,Domestic,10,2016-08-25,2016-08-26,8,25,976,1 days,8608401,7685953
875,10876,1,1,Donware,25-08-2016,Cincinnati,OH,2,Gary,IN,27-08-2016,696,671,2547,7963,71,Domestic,1,2016-08-25,2016-08-27,8,25,5416,2 days,8616364,7688500
2,10003,1,4,Quotelane,25-08-2016,Chicago,IL,4,Rockford,IL,29-08-2016,536,536,7276,5778,61,Domestic,10,2016-08-25,2016-08-29,8,25,-1498,4 days,8622142,7695776
955,10956,3,6,Blueit,25-08-2016,Detriot,MI,4,Monon,IN,29-08-2016,1159,566,6553,7238,92,Domestic,9,2016-08-25,2016-08-29,8,25,685,4 days,8629380,7702329
887,10888,2,3,Viatom,26-08-2016,Indianapolis,IN,1,Northbrook,IL,26-08-2016,898,309,1487,2112,100,Domestic,6,2016-08-26,2016-08-26,8,26,625,0 days,8631492,7703816
579,10580,2,5,Kinice,26-08-2016,Indianapolis,IN,8,Northbrook,IL,03-09-2016,991,656,421,582,62,International,9,2016-08-26,2016-09-03,8,26,161,8 days,8632074,7704237
379,10380,1,5,Beta-ron,26-08-2016,Milwaukee,WI,5,Springfield,IL,21-03-2016,204,204,8573,8815,95,International,5,2016-08-26,2016-03-21,8,26,242,-158 days,8640889,7712810
697,10698,1,8,Constreet,26-08-2016,Green Bay,WI,9,Joliet,IL,03-09-2016,1093,715,2788,2894,77,International,2,2016-08-26,2016-09-03,8,26,106,8 days,8643783,7715598
16,10017,2,8,Recode,26-08-2016,Bangor,MI,6,Davenport,IA,29-08-2016,525,460,2321,2656,71,International,4,2016-08-26,2016-08-29,8,26,335,3 days,8646439,7717919
1386,11387,2,6,Funlatlex,26-08-2016,Elgin,IL,7,Cincinnati,OH,02-09-2016,462,430,6162,7144,92,International,5,2016-08-26,2016-09-02,8,26,982,7 days,8653583,7724081
848,10849,1,5,Roundlam,26-08-2016,Madison,WI,2,Kalamazoo,MI,28-08-2016,885,527,7852,8476,74,Domestic,9,2016-08-26,2016-08-28,8,26,624,2 days,8662059,7731933
1588,11589,2,2,Ronlamice,26-08-2016,Springfield,IL,2,Skokie,IL,28-08-2016,1041,539,5065,5536,77,Intercom,8,2016-08-26,2016-08-28,8,26,471,2 days,8667595,7736998
700,10701,1,4,Trustcorporation,27-08-2016,Appleton,WI,1,Grand Rapids,MI,28-08-2016,542,542,7700,6346,98,Domestic,3,2016-08-27,2016-08-28,8,27,-1354,1 days,8673941,7744698
1285,11286,3,3,Medialax,27-08-2016,Monon,IN,4,Lansing,MI,31-08-2016,410,410,6966,7111,85,Domestic,1,2016-08-27,2016-08-31,8,27,145,4 days,8681052,7751664
1135,11136,2,5,Triootity,27-08-2016,Cincinnati,OH,2,Gary,IN,29-08-2016,425,425,2551,3222,59,Domestic,10,2016-08-27,2016-08-29,8,27,671,2 days,8684274,7754215
851,10852,1,3,Jaydox,27-08-2016,Rockford,IL,6,Green Bay,WI,02-09-2016,1098,786,1243,2060,84,International,2,2016-08-27,2016-09-02,8,27,817,6 days,8686334,7755458
43,10044,2,5,Yearlex,27-08-2016,Chicago,IL,9,Rockford,IL,05-09-2016,1166,250,2857,3320,54,International,5,2016-08-27,2016-09-05,8,27,463,9 days,8689654,7758315
1515,11516,2,2,Overtam,28-08-2016,Lansing,MI,1,Dayton,OH,29-08-2016,609,609,1097,1916,85,Intercom,6,2016-08-28,2016-08-29,8,28,819,1 days,8691570,7759412
612,10613,2,4,Fax-ex,28-08-2016,Cincinnati,OH,1,Gary,IN,29-08-2016,446,446,8698,6541,59,Domestic,10,2016-08-28,2016-08-29,8,28,-2157,1 days,8698111,7768110
1398,11399,2,5,Dingcan,28-08-2016,Green Bay,WI,1,Joliet,IL,29-08-2016,927,522,228,361,76,Domestic,8,2016-08-28,2016-08-29,8,28,133,1 days,8698472,7768338
323,10324,1,6,Xx-dotone,28-08-2016,Naperville,IL,7,Indianapolis,IN,04-09-2016,575,575,2798,3710,55,International,2,2016-08-28,2016-09-04,8,28,912,7 days,8702182,7771136
1373,11374,2,2,Planetware,29-08-2016,Detriot,MI,7,Monon,IN,03-09-2016,1028,264,1940,2780,58,International,4,2016-08-29,2016-09-03,8,29,840,5 days,8704962,7773076
713,10714,2,4,Matsanice,29-08-2016,Chicago,IL,2,Rockford,IL,31-08-2016,390,390,2572,890,84,Domestic,5,2016-08-29,2016-08-31,8,29,-1682,2 days,8705852,7775648
1435,11436,2,3,Danfan,29-08-2016,Indianapolis,IN,4,Northbrook,IL,31-08-2016,607,495,1863,2802,59,Domestic,1,2016-08-29,2016-08-31,8,29,939,2 days,8708654,7777511
226,10227,2,5,Icedox,29-08-2016,Grand Rapids,MI,2,Toledo,OH,31-08-2016,755,576,5104,5273,53,Domestic,1,2016-08-29,2016-08-31,8,29,169,2 days,8713927,7782615
64,10065,1,8,nimlab,29-08-2016,Indianapolis,IN,3,Northbrook,IL,01-09-2016,1172,737,6569,7298,99,Domestic,8,2016-08-29,2016-09-01,8,29,729,3 days,8721225,7789184
1590,11591,2,1,Aptaxon,29-08-2016,Indianapolis,IN,3,Northbrook,IL,01-09-2016,689,528,7908,11555,56,Domestic,8,2016-08-29,2016-09-01,8,29,3647,3 days,8732780,7797092
677,10678,2,8,Zamholdings,29-08-2016,Rockford,IL,2,Green Bay,WI,31-08-2016,762,660,7119,7571,99,Domestic,8,2016-08-29,2016-08-31,8,29,452,2 days,8740351,7804211
1480,11481,2,4,Bamgeohigh,29-08-2016,Northbrook,IL,4,Naperville,IL,02-09-2016,975,760,4776,2891,61,Domestic,7,2016-08-29,2016-09-02,8,29,-1885,4 days,8743242,7808987
76,10077,1,5,Pluslam,29-08-2016,Skokie,IL,9,Chicago,IL,21-03-2016,771,601,1954,2742,87,International,8,2016-08-29,2016-03-21,8,29,788,-161 days,8745984,7810941
1652,11653,3,5,Zerlane,29-08-2016,Chicago,IL,2,Rockford,IL,31-08-2016,232,232,4391,4655,62,Domestic,9,2016-08-29,2016-08-31,8,29,264,2 days,8750639,7815332
1500,11501,3,2,Recode,30-08-2016,Chicago,IL,9,Rockford,IL,07-09-2016,641,641,1315,1560,95,International,8,2016-08-30,2016-09-07,8,30,245,8 days,8752199,7816647
1094,11095,2,5,Dingcan,30-08-2016,Bangor,MI,7,Davenport,IA,05-09-2016,383,383,3340,3578,53,International,5,2016-08-30,2016-09-05,8,30,238,6 days,8755777,7819987
1561,11562,2,4,Dontam,30-08-2016,Lansing,MI,4,Dayton,OH,03-09-2016,1004,275,4979,2847,53,Domestic,4,2016-08-30,2016-09-03,8,30,-2132,4 days,8758624,7824966
113,10114,1,8,apzone,30-08-2016,Appleton,WI,2,Grand Rapids,MI,01-09-2016,378,378,7332,7485,78,Intercom,5,2016-08-30,2016-09-01,8,30,153,2 days,8766109,7832298
1460,11461,2,4,Conehotice,30-08-2016,Detriot,MI,2,Monon,IN,01-09-2016,684,590,7371,5030,50,Intercom,5,2016-08-30,2016-09-01,8,30,-2341,2 days,8771139,7839669
801,10802,2,7,Good-find,31-08-2016,Gary,IN,4,Milwaukee,WI,04-09-2016,1099,433,5312,6047,80,Domestic,3,2016-08-31,2016-09-04,8,31,735,4 days,8777186,7844981
1395,11396,2,4,Runhigh,31-08-2016,Joliet,IL,2,Madison,WI,02-09-2016,303,303,1794,137,63,Domestic,6,2016-08-31,2016-09-02,8,31,-1657,2 days,8777323,7846775
1243,11244,2,2,silfase,31-08-2016,Madison,WI,10,Kalamazoo,MI,07-09-2016,663,650,8122,8327,53,International,3,2016-08-31,2016-09-07,8,31,205,7 days,8785650,7854897
516,10517,2,5,Linezatlam,31-08-2016,Detriot,MI,3,Monon,IN,03-09-2016,1041,359,2189,2653,57,Domestic,2,2016-08-31,2016-09-03,8,31,464,3 days,8788303,7857086
63,10064,2,6,Plusla,31-08-2016,Chicago,IL,4,Rockford,IL,04-09-2016,419,419,337,1053,86,Domestic,10,2016-08-31,2016-09-04,8,31,716,4 days,8789356,7857423
85,10086,1,7,Saozoomtex,31-08-2016,Gary,IN,1,Milwaukee,WI,01-09-2016,1050,548,6381,7088,67,Domestic,8,2016-08-31,2016-09-01,8,31,707,1 days,8796444,7863804
130,10131,2,8,Zunice,31-08-2016,Joliet,IL,7,Madison,WI,07-09-2016,801,427,2219,2646,84,International,7,2016-08-31,2016-09-07,8,31,427,7 days,8799090,7866023
434,10435,1,6,Ronvivalam,31-08-2016,Madison,WI,6,Kalamazoo,MI,06-09-2016,469,300,5940,6656,62,International,3,2016-08-31,2016-09-06,8,31,716,6 days,8805746,7871963
1349,11350,3,2,Lexidom,31-08-2016,Detriot,MI,1,Monon,IN,01-09-2016,807,281,236,586,92,Intercom,1,2016-08-31,2016-09-01,8,31,350,1 days,8806332,7872199
1720,11721,2,3,Warecity,31-08-2016,Madison,WI,2,Kalamazoo,MI,02-09-2016,289,245,445,1184,58,Domestic,3,2016-08-31,2016-09-02,8,31,739,2 days,8807516,7872644
1782,11783,3,6,bamity,31-08-2016,Springfield,IL,8,Skokie,IL,08-09-2016,881,456,2486,3351,75,International,8,2016-08-31,2016-09-08,8,31,865,8 days,8810867,7875130
374,10375,2,6,Itdom,31-08-2016,Elgin,IL,3,Cincinnati,OH,02-09-2016,1138,244,1693,2492,99,Domestic,7,2016-08-31,2016-09-02,8,31,799,2 days,8813359,7876823
